AGAGAGCGTGC -> GAGAGCGTGCA
ATCTTTGTGTG -> TCTTTGTGTGA
AGATCGTAACC -> GATCGTAACCA
GGTGATACATT -> GTGATACATTA
TGCTCACGTTT -> GCTCACGTTTT
CCCACGCTTTC -> CCACGCTTTCC
GAGAGCGTGCA -> AGAGCGTGCAT
TACATTACGGC -> ACATTACGGCG
TCTGAGTGGGA -> CTGAGTGGGAT
AGCGCACGTCT -> GCGCACGTCTA
GTTAGCCCAGA -> TTAGCCCAGAT
GATCTTTGTGT -> ATCTTTGTGTG
AGATAAGCTCG -> GATAAGCTCGC
ACCCATTCAAT -> CCCATTCAATC
AGGGTTGGAGT -> GGGTTGGAGTG
ACCTTAGGGCC -> CCTTAGGGCCA
TAGGGTTGGAG -> AGGGTTGGAGT
CGTGCACCTTT -> GTGCACCTTTA
CAATAGCTACG -> AATAGCTACGT
AGGGAGCCTCA -> GGGAGCCTCAG
GTGAAAGATAA -> TGAAAGATAAG
TTATTATATTA -> TATTATATTAC
TCTTTGTGTGA -> CTTTGTGTGAG
CACTGCCGGAC -> ACTGCCGGACT
CAAGGACACGG -> AAGGACACGGG
ACGTGCACCTT -> CGTGCACCTTT
ATACCCTCGCG -> TACCCTCGCGT
CGATAGAGGTC -> GATAGAGGTCC
AATCACATGGG -> ATCACATGGGA
GAGCACCATCG -> AGCACCATCGA
CTCGACGACGG -> TCGACGACGGT
CTTGTGGAGGT -> TTGTGGAGGTG
GAACCACTTAT -> AACCACTTATA
ACTTCTACGCC -> CTTCTACGCCA
CCTCTGCATTT -> CTCTGCATTTG
ACGACGGTAGC -> CGACGGTAGCA
AATTTCCTGAC -> ATTTCCTGACT
ACGTCTAACGC -> CGTCTAACGCG
TGTGTTGAGAC -> GTGTTGAGACA
GCTGTAGCTTA -> CTGTAGCTTAT
TGACGTGAACT -> GACGTGAACTC
CCCAGATGACG -> CCAGATGACGT
CTGTAGCTTAT -> TGTAGCTTATG
CCGCAGCACGC -> CGCAGCACGCA
AAAATCCCGAA -> AAATCCCGAAT
TAAACCTCCGT -> AAACCTCCGTC
TGGTGTGGCGA -> GGTGTGGCGAC
CACTTAGCTTC -> ACTTAGCTTCT
TTGATCTGTGC -> TGATCTGTGCT
AAACTAAGTAA -> AACTAAGTAAC
TGCGCACTATG -> GCGCACTATGC
TCGGCCTCAAC -> CGGCCTCAACG
AGGCCACTTCC -> GGCCACTTCCA
TCGAGGGCCAG -> CGAGGGCCAGA
TCAAATAAGGA -> CAAATAAGGAC
GGCTTAGCGGC -> GCTTAGCGGCA
GGACCCGAGTG -> GACCCGAGTGA
ATATTTAGGAG -> TATTTAGGAGA
ATGGGGCCCCG -> TGGGGCCCCGC
TGGGGTTATTT -> GGGGTTATTTT
GAATAAGGAAT -> AATAAGGAATT
CAGAATGGCGA -> AGAATGGCGAG
TCCTCTTTGCG -> CCTCTTTGCGT
CCCGCAGCACG -> CCGCAGCACGC
GATAGTTCTAC -> ATAGTTCTACT
CAGTTATTCCG -> AGTTATTCCGC
TGAAAGCCAAA -> GAAAGCCAAAT
GCCAAGTAGTC -> CCAAGTAGTCG
GCGGACCCATG -> CGGACCCATGA
GTGCTCGGCCT -> TGCTCGGCCTC
CAAGGAACATT -> AAGGAACATTT
ATCAGCAAAAA -> TCAGCAAAAAC
CCAGTTATTCC -> CAGTTATTCCG
GGGAGGAGTCG -> GGAGGAGTCGG
CCAAGGAATCA -> CAAGGAATCAC
GAAGCGCACGT -> AAGCGCACGTC
CAATCCACGGG -> AATCCACGGGA
GCATATATTTA -> CATATATTTAG
TCCAGGAGGGC -> CCAGGAGGGCC
CGTTGAATAGG -> GTTGAATAGGG
ACGCACGAGCC -> CGCACGAGCCC
GGCTGTTGATC -> GCTGTTGATCT
AGACCTATGCA -> GACCTATGCAG
TCGATCTTTGT -> CGATCTTTGTG
AGCCTCAGGGC -> GCCTCAGGGCT
CTAACGCGCGG -> TAACGCGCGGA
CCATGTTACAG -> CATGTTACAGC
TTCCCAAGGAA -> TCCCAAGGAAT
TGGTTCCCAAG -> GGTTCCCAAGG
CGGATAACGTC -> GGATAACGTCT
CTTTCCAGGAG -> TTTCCAGGAGG
AACGTCTCGAG -> ACGTCTCGAGG
TGTTGAGACAA -> GTTGAGACAAG
AGGGTAAGCAA -> GGGTAAGCAAT
TCTGAAGTCCG -> CTGAAGTCCGT
TGCGGACCCAT -> GCGGACCCATG
GCTTTCTGAAA -> CTTTCTGAAAT
TTTGGCGTCGA -> TTGGCGTCGAA
CAAGTATCCGC -> AAGTATCCGCG
GCATTTCAGAA -> CATTTCAGAAG
GTAAGCAATAT -> TAAGCAATATC
CTCTGAGTGGG -> TCTGAGTGGGA
GGGATGCAAGT -> GGATGCAAGTT
GGGGAAAGCTG -> GGGAAAGCTGT
CGCGCGGAGCC -> GCGCGGAGCCT
ATAAGCTCGCA -> TAAGCTCGCAG
TATCCGGATAG -> ATCCGGATAGT
ATGTCTTCCAG -> TGTCTTCCAGT
AGGGCCACTGT -> GGGCCACTGTC
CAGAGAGCGTG -> AGAGAGCGTGC
CCTTTGGCGTC -> CTTTGGCGTCG
CTACCTACCTT -> TACCTACCTTA
TAGATCGTAAC -> AGATCGTAACC
AAGGCAGGGTA -> AGGCAGGGTAG
AGAGGTCCAGA -> GAGGTCCAGAT
TAGGGACGAAG -> AGGGACGAAGC
TGTCTAGGGTT -> GTCTAGGGTTG
CATGAATTGAA -> ATGAATTGAAA
GACACGGGGAG -> ACACGGGGAGG
CAGACGCTATC -> AGACGCTATCT
CAACCCCACGC -> AACCCCACGCT
ACCTACCTTAG -> CCTACCTTAGG
GACGCTATCTA -> ACGCTATCTAA
AGCAGGATAAA -> GCAGGATAAAC
CGGATTATGAT -> GGATTATGATG
CCCGCGATTGC -> CCGCGATTGCT
CTGGCACAGGT -> TGGCACAGGTC
GCTCGAGAAAG -> CTCGAGAAAGG
AGGCTAGTGTA -> GGCTAGTGTAT
AGTTCCTGTGA -> GTTCCTGTGAA
TTGAAGCAGGA -> TGAAGCAGGAT
TCAATCCGCAA -> CAATCCGCAAG
TTTGCCAAGTA -> TTGCCAAGTAG
TTTGCAACTCC -> TTGCAACTCCG
TCAGGGCTGTT -> CAGGGCTGTTG
TTGGTTCCCAA -> TGGTTCCCAAG
AACCTCCGTCT -> ACCTCCGTCTC
TTATCAGAAGT -> TATCAGAAGTT
CCATAGTCATT -> CATAGTCATTC
TCAAGGACACG -> CAAGGACACGG
TGGAAAACTAA -> GGAAAACTAAG
CACCACTGCCG -> ACCACTGCCGG
CGCGGACAGAG -> GCGGACAGAGA
CGAGGGCTCAG -> GAGGGCTCAGA
CAGCGGGTTTG -> AGCGGGTTTGG
CATGGGACCCG -> ATGGGACCCGA
ACTTATACACG -> CTTATACACGT
GGTCCACAACA -> GTCCACAACAT
GGTCCAATAGC -> GTCCAATAGCA
CCCGAATCGCT -> CCGAATCGCTG
CGTCAATCCGC -> GTCAATCCGCA
TTACGGCGATC -> TACGGCGATCG
GCTGGCACAGG -> CTGGCACAGGT
TGGGAACGTTG -> GGGAACGTTGA
TTTCCAGGAGG -> TTCCAGGAGGG
AGACCATCACT -> GACCATCACTT
GCTTAGCGGCA -> CTTAGCGGCAA
TCCGGTGGTGT -> CCGGTGGTGTG
TGTGAAGCGCA -> GTGAAGCGCAC
ATTTGCCAAGT -> TTTGCCAAGTA
CTGATCACCAC -> TGATCACCACT
CATGCGGTTGC -> ATGCGGTTGCC
GTGGAGGTGTC -> TGGAGGTGTCT
CGAAGGCAGGG -> GAAGGCAGGGT
AAATCGTGGCC -> AATCGTGGCCT
CGGGCTCGACG -> GGGCTCGACGA
ATGGATTCCCT -> TGGATTCCCTG
TTCATTGCCCT -> TCATTGCCCTG
CAATTTCCTGA -> AATTTCCTGAC
CAGAAGGATGG -> AGAAGGATGGG
TTCAACTTTCG -> TCAACTTTCGA
TTCCATGCGGC -> TCCATGCGGCC
CTTTGTGTGAG -> TTTGTGTGAGT
TTATATTACCC -> TATATTACCCC
GGTGTGGCGAC -> GTGTGGCGACA
CTGCCGGACTA -> TGCCGGACTAG
GATTCCCTGGA -> ATTCCCTGGAA
GGATACCCTCG -> GATACCCTCGC
ATTACCCCGCG -> TTACCCCGCGC
GCTTATGGTTA -> CTTATGGTTAG
GAAGTCCGTAC -> AAGTCCGTACT
GACAGTTCACA -> ACAGTTCACAT
AGCGTGCATCA -> GCGTGCATCAC
GGTTCCCAAGG -> GTTCCCAAGGA
CTGAAGTCCGT -> TGAAGTCCGTA
ACTTCCATGCG -> CTTCCATGCGG
TTTTACCTATC -> TTTACCTATCG
ATCTGAAGTCC -> TCTGAAGTCCG
CTGAGGTACAA -> TGAGGTACAAA
TTTAGTGGCAC -> TTAGTGGCACC
CGGTAGCATTT -> GGTAGCATTTC
CCGCCACACAA -> CGCCACACAAG
CAAACCAACAG -> AAACCAACAGC
GGTATACAGAA -> GTATACAGAAT
ACCTATGATCT -> CCTATGATCTG
TGTATCCTCTT -> GTATCCTCTTT
TGTTACAGCAA -> GTTACAGCAAG
ATACATTACGG -> TACATTACGGC
GACTTCTACGC -> ACTTCTACGCC
GGACACGGGGA -> GACACGGGGAG
ATCGAAAGTGT -> TCGAAAGTGTG
GACCTATGCAG -> ACCTATGCAGA
CAGAAATTGGG -> AGAAATTGGGT
ATTACGGCGAT -> TTACGGCGATC
GACGGGGTTTG -> ACGGGGTTTGG
CCTCAACGAGA -> CTCAACGAGAG
GCACAGCAAGG -> CACAGCAAGGT
AATGGCGAGGG -> ATGGCGAGGGC
GTATGGGGCCC -> TATGGGGCCCC
AACCAAATCCG -> ACCAAATCCGG
AGATTTCAAAT -> GATTTCAAATA
GAGACAAGAGC -> AGACAAGAGCT
AATCCTGCCCC -> ATCCTGCCCCG
CTCTAATATGT -> TCTAATATGTC
CATAGTCATTC -> ATAGTCATTCA
CACACAAGACC -> ACACAAGACCC
TTTACCTATCG -> TTACCTATCGA
GAAGGCAGGGT -> AAGGCAGGGTA
GGGGTTATTTT -> GGGTTATTTTA
AGAAGGATGGG -> GAAGGATGGGA
ATGCAGAAGGG -> TGCAGAAGGGC
ACCCGCGAACT -> CCCGCGAACTA
ACTTATCTGAA -> CTTATCTGAAG
TGCCAAACCAA -> GCCAAACCAAC
ACTTGCACGTG -> CTTGCACGTGC
CTCACGTTTTG -> TCACGTTTTGT
AGGGTAGGGGA -> GGGTAGGGGAT
TATGTCTTCCA -> ATGTCTTCCAG
GCCAACCCCAC -> CCAACCCCACG
CTATCTAAGGT -> TATCTAAGGTC
AGGGCCAGACG -> GGGCCAGACGC
GAATTGAAAGC -> AATTGAAAGCC
AGCAACCAAAT -> GCAACCAAATC
ACCAACAGCAT -> CCAACAGCATC
GCAGCATGAAT -> CAGCATGAATT
TGATGAGTCAC -> GATGAGTCACG
CGCGATTGCTT -> GCGATTGCTTT
ATCCTCTGCAT -> TCCTCTGCATT
CACAATTAAAT -> ACAATTAAATG
AGTAAAAAATA -> GTAAAAAATAC
TTGTGTTGAGA -> TGTGTTGAGAC
AGGACACGGGG -> GGACACGGGGA
GAGGGCCACTG -> AGGGCCACTGT
CAAAAACTCGA -> AAAAACTCGAA
ACCGTGACCCA -> CCGTGACCCAC
AACGACAGAGA -> ACGACAGAGAG
TCGCGTATGGG -> CGCGTATGGGG
GAGTGAATAAG -> AGTGAATAAGA
TCTGAGGTACA -> CTGAGGTACAA
TAGGAGACTTC -> AGGAGACTTCT
GCGGAGCCTAC -> CGGAGCCTACC
GGAGGGCCACT -> GAGGGCCACTG
TGCAGGATTGA -> GCAGGATTGAT
CACCATCGATC -> ACCATCGATCA
CAACCGATATT -> AACCGATATTA
AAATGCACTCG -> AATGCACTCGG
TAGGGTAAGCA -> AGGGTAAGCAA
GAGTGTATCAG -> AGTGTATCAGC
GGTAGGGGATG -> GTAGGGGATGC
GAAATTGGGTG -> AAATTGGGTGG
CTAAGTTCGGG -> TAAGTTCGGGG
TTACTAATCGC -> TACTAATCGCG
GGCTCAGAGTG -> GCTCAGAGTGT
AGCCCGAGGCA -> GCCCGAGGCAC
TGAGTCTCATT -> GAGTCTCATTC
GCCACTGTCGC -> CCACTGTCGCT
AGGAGTCGGAT -> GGAGTCGGATT
AAGGACAGTTC -> AGGACAGTTCA
GTCCAATAGCA -> TCCAATAGCAT
ACTTCAAGTAT -> CTTCAAGTATC
ACACGGGGAGG -> CACGGGGAGGA
TAAGTAACAGA -> AAGTAACAGAA
CTGTGAAGCGC -> TGTGAAGCGCA
CCTTTATGGAT -> CTTTATGGATT
CACCTATGATC -> ACCTATGATCT
TCCAGATCTGA -> CCAGATCTGAC
CTACTTATCTG -> TACTTATCTGA
GCTATTAGGTA -> CTATTAGGTAT
ATTTCAGAAGG -> TTTCAGAAGGA
AATAGCATATA -> ATAGCATATAT
ACCATAGTCAT -> CCATAGTCATT
TCGGATTATGA -> CGGATTATGAT
TGAATTGAAAG -> GAATTGAAAGC
AAGGCGCTGGA -> AGGCGCTGGAA
CGGCAAGAATA -> GGCAAGAATAT
TTTGAAAGCCA -> TTGAAAGCCAA
AGTTCCCGTCG -> GTTCCCGTCGG
GTTTTGTGTTG -> TTTTGTGTTGA
ATTTAGGAGAC -> TTTAGGAGACT
TGCATTTGTAC -> GCATTTGTACA
CGAGTGAATAA -> GAGTGAATAAG
TGCGTCACGTC -> GCGTCACGTCA
AATTGAAAGCC -> ATTGAAAGCCT
GGGTTTGGTTC -> GGTTTGGTTCC
AGTGGCACCCA -> GTGGCACCCAA
GCGGATAACGT -> CGGATAACGTC
AAAAGGCTTAG -> AAAGGCTTAGC
CACTAGTAAAA -> ACTAGTAAAAA
CGCGAAGTTAT -> GCGAAGTTATT
ACATTACGGCG -> CATTACGGCGA
TGCTCGGCCTC -> GCTCGGCCTCA
AGCAAGCTATT -> GCAAGCTATTA
ACAGCAAGGTC -> CAGCAAGGTCC
CAGCAAGGTCC -> AGCAAGGTCCA
GGCTAGTGTAT -> GCTAGTGTATC
ATCGTAACCAG -> TCGTAACCAGA
CGGAGCACCAT -> GGAGCACCATC
AAAAAATACAG -> AAAAATACAGC
TATCCTCTTTG -> ATCCTCTTTGC
CAGCGCGACAT -> AGCGCGACATG
GTGAACGACAG -> TGAACGACAGA
TCGCAGTAGAA -> CGCAGTAGAAC
TAGCGGCAAGA -> AGCGGCAAGAA
CGAAGCTCGCT -> GAAGCTCGCTT
ATGGGACCCGA -> TGGGACCCGAG
TTGAGACAAGA -> TGAGACAAGAG
CTGGGAACGTT -> TGGGAACGTTG
TGTGAGTCTCA -> GTGAGTCTCAT
ACAATTAAATG -> CAATTAAATGC
TCATTCATTGC -> CATTCATTGCC
TCACCTATGAT -> CACCTATGATC
CCTACCTTAGG -> CTACCTTAGGG
GAGAAAGGCGG -> AGAAAGGCGGC
TACCCAGACCT -> ACCCAGACCTA
GTTTTTGCAAC -> TTTTTGCAACT
GCACGTGCACC -> CACGTGCACCT
GGCGAGGGCTC -> GCGAGGGCTCA
GGGCTCAGAGT -> GGCTCAGAGTG
GAAAGCTGTGA -> AAAGCTGTGAT
CTTTGCGTCAC -> TTTGCGTCACG
TGCACTCGGAA -> GCACTCGGAAA
CGTCAAGGACA -> GTCAAGGACAC
TCTGATCACCA -> CTGATCACCAC
GGACAGTTCAC -> GACAGTTCACA
ATATCTGGTGA -> TATCTGGTGAA
ACTGCCTCTCT -> CTGCCTCTCTC
GGAGCCTACCC -> GAGCCTACCCA
CTAGGGTTGGA -> TAGGGTTGGAG
GAAGGGCTAAC -> AAGGGCTAACG
TTAGGTATACA -> TAGGTATACAG
TCACACGTCCT -> CACACGTCCTG
AATACGCCCGC -> ATACGCCCGCA
GAGGTCCAGAT -> AGGTCCAGATC
CAAGTTACCGT -> AAGTTACCGTG
AGTGCTCACGT -> GTGCTCACGTT
GAGCTCCAGGC -> AGCTCCAGGCT
GCCTACCCAGA -> CCTACCCAGAC
ACCCAGACCTA -> CCCAGACCTAT
TTCACATGGGA -> TCACATGGGAC
TTGCAACTCCG -> TGCAACTCCGC
CCTATGCAGAA -> CTATGCAGAAG
GTCCTAGGCCA -> TCCTAGGCCAC
GTCCTGGGAAC -> TCCTGGGAACG
GGCCATGTTAC -> GCCATGTTACA
ATTCCGCCACA -> TTCCGCCACAC
GAGGAGTCGGA -> AGGAGTCGGAT
AGGTCGAACCA -> GGTCGAACCAC
CCGTACTGCCT -> CGTACTGCCTC
GGGCTGTTGAT -> GGCTGTTGATC
GAGTCGGATTA -> AGTCGGATTAT
AAAGCCAAATT -> AAGCCAAATTC
CGCGAACTAAG -> GCGAACTAAGT
GGCCTACCTAC -> GCCTACCTACC
GAATAAGACCT -> AATAAGACCTT
TTGAAAGCCTG -> TGAAAGCCTGT
ATCGTTATCAG -> TCGTTATCAGA
GTCATTCAACT -> TCATTCAACTT
CTGTGCTCGGC -> TGTGCTCGGCC
CTTACCCAAGG -> TTACCCAAGGG
CGGAGCCTACC -> GGAGCCTACCC
GGACGTCAATC -> GACGTCAATCC
CTGACTTGCAC -> TGACTTGCACG
ATCCTCTTTGC -> TCCTCTTTGCG
AAGGTCGAACC -> AGGTCGAACCA
GTAGCTTATGG -> TAGCTTATGGT
AACGCACGAGC -> ACGCACGAGCC
TCGATTGGCAA -> CGATTGGCAAG
ATTCAACTTTC -> TTCAACTTTCG
CCTGACTTGCA -> CTGACTTGCAC
CGAGAGCAACC -> GAGAGCAACCA
GGCTATGCTCG -> GCTATGCTCGA
CCTGGAAGGCT -> CTGGAAGGCTA
GTGTATCAGCA -> TGTATCAGCAA
GCACCTTTATG -> CACCTTTATGG
TAGAACACTTA -> AGAACACTTAG
GGAACATTTTG -> GAACATTTTGA
CATTTCGAGGT -> ATTTCGAGGTT
AGTGTATCCTC -> GTGTATCCTCT
GCGCGGAGCCT -> CGCGGAGCCTA
CTGCATCCCGC -> TGCATCCCGCA
AGGTACAAACC -> GGTACAAACCA
ATTGCTTTACA -> TTGCTTTACAA
GATGACGTGAA -> ATGACGTGAAC
ACTCGAAATCC -> CTCGAAATCCT
ATCACCACTGC -> TCACCACTGCC
GCAGCACGCAG -> CAGCACGCAGG
AGTCTCATTCA -> GTCTCATTCAT
AGTGGGATCTA -> GTGGGATCTAT
TCTATTCTAAA -> CTATTCTAAAT
TCTCCCGCGAT -> CTCCCGCGATT
CAATCCGCAAG -> AATCCGCAAGA
CTCGCAGTAGA -> TCGCAGTAGAA
AGGAGACTTCT -> GGAGACTTCTA
GAAGGCCGCAT -> AAGGCCGCATG
ATGAGGGAGCC -> TGAGGGAGCCT
CGCTTCCAACC -> GCTTCCAACCG
CATCACGACAG -> ATCACGACAGC
GTCTCGAGGGC -> TCTCGAGGGCC
AAAGGCGGCGA -> AAGGCGGCGAG
ACGAAGCTCGC -> CGAAGCTCGCT
CCAATAGCATA -> CAATAGCATAT
CTAACGCACGA -> TAACGCACGAG
TACTGCCTCTC -> ACTGCCTCTCT
CGCTGTAGCTT -> GCTGTAGCTTA
CAAGTAGTCGC -> AAGTAGTCGCT
ATATTACCCCG -> TATTACCCCGC
GCACTCGGAAA -> CACTCGGAAAA
AAAGCTGTGAT -> AAGCTGTGATC
TTCCGCCACAC -> TCCGCCACACA
AACTAAGTAAC -> ACTAAGTAACA
TGAAAGATAAG -> GAAAGATAAGC
GCCACACAAGA -> CCACACAAGAC
GATAAGCTCGC -> ATAAGCTCGCA
TACGGCGATCG -> ACGGCGATCGT
CCTCGCGTCAA -> CTCGCGTCAAT
TATGATCTGAA -> ATGATCTGAAG
CCCCGCATATC -> CCCGCATATCT
CAACTTTCGAT -> AACTTTCGATA
CGTGGCCTACC -> GTGGCCTACCT
CTTTCGATAAA -> TTTCGATAAAC
CACAGCAAGGT -> ACAGCAAGGTC
GAACTAAGTTC -> AACTAAGTTCG
AGTCACACGTC -> GTCACACGTCC
GACGTCAATCC -> ACGTCAATCCG
CACTCGGAAAA -> ACTCGGAAAAG
GCGCATGCGGT -> CGCATGCGGTT
GGCAGTAGTTC -> GCAGTAGTTCT
GGAGGAGTCGG -> GAGGAGTCGGA
CCAGATCTGAC -> CAGATCTGACT
CTGAAGTCGTT -> TGAAGTCGTTT
CTGCATTTGTA -> TGCATTTGTAC
ATCCGAGTCAC -> TCCGAGTCACA
TTCCAGGAGGG -> TCCAGGAGGGC
AGAAGGGCTAA -> GAAGGGCTAAC
CTATATGTTAC -> TATATGTTACC
TACGCGGACAG -> ACGCGGACAGA
AAGGAATCACA -> AGGAATCACAT
CAAGAGCTCCA -> AAGAGCTCCAG
TACAGAATGGC -> ACAGAATGGCG
GGACAGAGAGC -> GACAGAGAGCG
AAGCTGTGATC -> AGCTGTGATCG
CGAAAGTGTGG -> GAAAGTGTGGA
TGTCGGGCTCG -> GTCGGGCTCGA
TTCAATCCACG -> TCAATCCACGG
GAATCACATGG -> AATCACATGGG
TGAATAAGACC -> GAATAAGACCT
CCCGCATATCT -> CCGCATATCTG
ATCCACGGGAC -> TCCACGGGACG
GGAGCACCATC -> GAGCACCATCG
AGTTCTCCCGC -> GTTCTCCCGCG
GAATGGCGAGG -> AATGGCGAGGG
ACAGCAAGCTA -> CAGCAAGCTAT
TGAAGCGCACG -> GAAGCGCACGT
AGGTTTTACCT -> GGTTTTACCTA
TTCCCGTCGGA -> TCCCGTCGGAT
GCACCCAATTT -> CACCCAATTTG
CATCGATCACC -> ATCGATCACCT
TGCCGGACTAG -> GCCGGACTAGA
TGGCGTCGAAG -> GGCGTCGAAGG
GGGATCTATTC -> GGATCTATTCT
CTAAGTAACAG -> TAAGTAACAGA
TTTCAAATAAG -> TTCAAATAAGG
TCCGCGCATGC -> CCGCGCATGCG
CCATTTCGAGG -> CATTTCGAGGT
CGTAACCAGAA -> GTAACCAGAAG
GCATGCGGTTG -> CATGCGGTTGC
TGTATAGCTAG -> GTATAGCTAGT
TACCCTCGCGT -> ACCCTCGCGTC
GGGCTCGACGA -> GGCTCGACGAC
AAATAAGGACA -> AATAAGGACAG
GTGAATAAGAC -> TGAATAAGACC
TACAGCAAGCT -> ACAGCAAGCTA
CAAGTTCCTGT -> AAGTTCCTGTG
TTCTTGAAGCA -> TCTTGAAGCAG
AGAATATAAAT -> GAATATAAATA
ATGGGACGGGT -> TGGGACGGGTG
AAGGGGAATAA -> AGGGGAATAAG
TCTTCCAGTTA -> CTTCCAGTTAT
TGAGTGGGATC -> GAGTGGGATCT
TTGTACACTAG -> TGTACACTAGT
TTTGTACACTA -> TTGTACACTAG
GGTTGGAGTGC -> GTTGGAGTGCT
GTATCCGCGCA -> TATCCGCGCAT
GAACGTTGAAT -> AACGTTGAATA
AACAGCATCCG -> ACAGCATCCGC
TAGTAAAAAAT -> AGTAAAAAATA
ATCTATTCTAA -> TCTATTCTAAA
GCTATCTAAGG -> CTATCTAAGGT
GTGCATACCCG -> TGCATACCCGC
CAGGCTATGCT -> AGGCTATGCTC
CCTGGGAACGT -> CTGGGAACGTT
CAGACCTATGC -> AGACCTATGCA
GGATGGGAAGG -> GATGGGAAGGA
ATTCCCTGGAA -> TTCCCTGGAAG
CGCAAGAAGGC -> GCAAGAAGGCC
TTATGGTTAGC -> TATGGTTAGCC
TAACGCGCGGA -> AACGCGCGGAG
GTTGTGCATAC -> TTGTGCATACC
GGATTATGATG -> GATTATGATGT
ATCACGACAGC -> TCACGACAGCG
GCATATCTGGT -> CATATCTGGTG
TGCGGTTGTGC -> GCGGTTGTGCA
AAGTAGTCGCT -> AGTAGTCGCTT
GACCCATTCAA -> ACCCATTCAAT
CCAACCCCACG -> CAACCCCACGC
TCGGATCTGAT -> CGGATCTGATC
CTAGAGCAGCA -> TAGAGCAGCAT
GATTTCAAATA -> ATTTCAAATAA
GGTAGCATTTC -> GTAGCATTTCA
GTTGCCAATCC -> TTGCCAATCCG
AAGGAACATTT -> AGGAACATTTT
ACAGAGAGCGG -> CAGAGAGCGGA
CATGTTACAGC -> ATGTTACAGCA
CGGATCTGATC -> GGATCTGATCA
CCAATTTGCCA -> CAATTTGCCAA
TTTTAGTGGCA -> TTTAGTGGCAC
CTCGATCTTTG -> TCGATCTTTGT
CCCAATTTGCC -> CCAATTTGCCA
GCACAATTAAA -> CACAATTAAAT
GGACGAAGCTC -> GACGAAGCTCG
GTCACACGTCC -> TCACACGTCCT
TCCGCAAGAAG -> CCGCAAGAAGG
GCATACCCGCG -> CATACCCGCGA
CCTGGCTTTCT -> CTGGCTTTCTG
GATCACCTATG -> ATCACCTATGA
ACGGCGATCGT -> CGGCGATCGTG
GGAAAAGTTCC -> GAAAAGTTCCC
CAACAGCATCC -> AACAGCATCCG
AAAAATACAGC -> AAAATACAGCG
CGCCACACAAG -> GCCACACAAGA
GGGCTAACGCA -> GGCTAACGCAC
CTGTTGATCTG -> TGTTGATCTGT
CTCCGTCTCTA -> TCCGTCTCTAA
GGACGGGGTTT -> GACGGGGTTTG
GGGTAAGCAAT -> GGTAAGCAATA
GACTTCAAGTA -> ACTTCAAGTAT
AACTATATGTT -> ACTATATGTTA
TGAACGACAGA -> GAACGACAGAG
CGCTTGTGGAG -> GCTTGTGGAGG
CTGAAATCGTG -> TGAAATCGTGG
GGAATTAGTAC -> GAATTAGTACG
CGCCCGCAGCA -> GCCCGCAGCAC
GTTATTATATT -> TTATTATATTA
ACCATCGATCA -> CCATCGATCAC
CCCTGGCTTTC -> CCTGGCTTTCT
TCTAAATATGA -> CTAAATATGAC
TTGCACGTGCA -> TGCACGTGCAC
ATCAGAAGTTC -> TCAGAAGTTCT
CGGGGGGGAAA -> GGGGGGGAAAG
GCAATATCCGG -> CAATATCCGGA
CTTTCTGAAAT -> TTTCTGAAATC
CAACCAAATCC -> AACCAAATCCG
ATACCCGCGAA -> TACCCGCGAAC
TTTTGCAACTC -> TTTGCAACTCC
ACTAGTAAAAA -> CTAGTAAAAAA
GTTCCCGTCGG -> TTCCCGTCGGA
CTGACTTCAAG -> TGACTTCAAGT
AGTGAATAAGA -> GTGAATAAGAC
GGACCCATGAG -> GACCCATGAGG
TCCCGAATCGC -> CCCGAATCGCT
TTCAAATAAGG -> TCAAATAAGGA
GCCACTTCCAT -> CCACTTCCATG
CCTTAGGGCCA -> CTTAGGGCCAT
CAAATAAGGAC -> AAATAAGGACA
AGCTACGTGAA -> GCTACGTGAAC
GTCTAACGCGC -> TCTAACGCGCG
CGATATTACTA -> GATATTACTAA
GGAAAACTAAG -> GAAAACTAAGT
TCCCGCATCTC -> CCCGCATCTCG
TTCTACTTATC -> TCTACTTATCT
CAAGAAGGCCG -> AAGAAGGCCGC
CCGTCTCTAAT -> CGTCTCTAATA
CGATCTTTGTG -> GATCTTTGTGT
TCTCTCCAGAG -> CTCTCCAGAGA
CATCCGCCATT -> ATCCGCCATTT
CAGGGTAGGGG -> AGGGTAGGGGA
TCGCTGTAGCT -> CGCTGTAGCTT
CTATGCAGAAG -> TATGCAGAAGG
CCTGTAGTGCG -> CTGTAGTGCGG
GGGAGCCTCAG -> GGAGCCTCAGG
AGAACACTTAG -> GAACACTTAGC
GACCCGAGTGA -> ACCCGAGTGAA
CAAGGGGAATA -> AAGGGGAATAA
CGAGGTTTTAC -> GAGGTTTTACC
CTGGAAAACTA -> TGGAAAACTAA
CGATCGTGGAC -> GATCGTGGACG
GAATATAAATA -> AATATAAATAC
ACCTCCGTCTC -> CCTCCGTCTCT
CATTTTGAAAG -> ATTTTGAAAGC
CGTCTAACGCG -> GTCTAACGCGC
TTGATGAGTCA -> TGATGAGTCAC
ACAGAATGGCG -> CAGAATGGCGA
CCAAGTAGTCG -> CAAGTAGTCGC
TATAGCTAGTT -> ATAGCTAGTTT
AAGCCTGTAGT -> AGCCTGTAGTG
CAGCACGCAGG -> AGCACGCAGGG
TCTGGTGAAAG -> CTGGTGAAAGA
TTTCAGAAGGA -> TTCAGAAGGAT
AGCTCGCTTCC -> GCTCGCTTCCA
TTAAATGCACT -> TAAATGCACTC
AGGGGAATAAG -> GGGGAATAAGG
TCGGGGTCCAC -> CGGGGTCCACA
CTTCTACGCCA -> TTCTACGCCAC
TCCTGCCCCGT -> CCTGCCCCGTT
TCTCATTCATT -> CTCATTCATTG
TGTCTTCCAGT -> GTCTTCCAGTT
CACGGGACGGG -> ACGGGACGGGG
ATTGCCCTGGC -> TTGCCCTGGCT
CAGAAGTTCTC -> AGAAGTTCTCC
TAGGGCCATGT -> AGGGCCATGTT
ATATCCGGATA -> TATCCGGATAG
TGAAGCAGGAT -> GAAGCAGGATA
AATTAAATGCA -> ATTAAATGCAC
AGCATCCGCCA -> GCATCCGCCAT
TTATCTGAAGT -> TATCTGAAGTC
GGGGGGGAAAG -> GGGGGGAAAGC
CTAGGCCACTT -> TAGGCCACTTC
GACCATCACTT -> ACCATCACTTA
CATGCCAAACC -> ATGCCAAACCA
GCGTCGAAGGC -> CGTCGAAGGCA
CTAATATGTCT -> TAATATGTCTT
AGCCCAGATGA -> GCCCAGATGAC
GGCCACTGTCG -> GCCACTGTCGC
GACATGCAGGA -> ACATGCAGGAT
ACAGCGGGTTT -> CAGCGGGTTTG
AAAGGCTTAGC -> AAGGCTTAGCG
ACGGTAGCATT -> CGGTAGCATTT
CCCTCGCGTCA -> CCTCGCGTCAA
CCCGTCGGATC -> CCGTCGGATCT
AGGCAGGGTAG -> GGCAGGGTAGG
GTCGGGCTCGA -> TCGGGCTCGAC
CGTGAACTCTG -> GTGAACTCTGA
CCGCGAAGTTA -> CGCGAAGTTAT
GATCTGAAGTC -> ATCTGAAGTCG
GTAGAACACTT -> TAGAACACTTA
AGGTCGAACTA -> GGTCGAACTAT
AGGATGGGAAG -> GGATGGGAAGG
GGCGCTGGAAA -> GCGCTGGAAAA
AGATCTGACTT -> GATCTGACTTC
TTAGCTTCTTG -> TAGCTTCTTGA
GGCGTCGAAGG -> GCGTCGAAGGC
TATGCAGAAGG -> ATGCAGAAGGG
GCCTCAGGGCT -> CCTCAGGGCTG
GACGGGTGCAC -> ACGGGTGCACA
TGAAGTCCGTA -> GAAGTCCGTAC
GCGAACTAAGT -> CGAACTAAGTT
TGCCCCGTTGA -> GCCCCGTTGAT
GGCGAGATTTC -> GCGAGATTTCA
AGACAAGAGCT -> GACAAGAGCTC
CGAATCGCTGT -> GAATCGCTGTA
CCACACAAGAC -> CACACAAGACC
GGGTAGGGGAT -> GGTAGGGGATG
ACCCACAACTA -> CCCACAACTAA
GTCGGATCTGA -> TCGGATCTGAT
GCGCACGTCTA -> CGCACGTCTAA
TCGCTTCCAAC -> CGCTTCCAACC
CAACTCCGCGA -> AACTCCGCGAA
TGGGACCCGAG -> GGGACCCGAGT
AAGGTCCAATA -> AGGTCCAATAG
AGCATTTCAGA -> GCATTTCAGAA
AAGGCCGCATG -> AGGCCGCATGC
AAGCTATTAGG -> AGCTATTAGGT
GAGAGCAACCA -> AGAGCAACCAA
TACCCGCGAAC -> ACCCGCGAACT
TTTGTGTTGAG -> TTGTGTTGAGA
TATAAATACGC -> ATAAATACGCC
CCGGATAGTTC -> CGGATAGTTCT
GTCGCTTGTGG -> TCGCTTGTGGA
AGATGACGTGA -> GATGACGTGAA
GAACACTTAGC -> AACACTTAGCT
CTGAGTGGGAT -> TGAGTGGGATC
TCAACTTTCGA -> CAACTTTCGAT
GCCCGCAGCAC -> CCCGCAGCACG
CGTCTCGAGGG -> GTCTCGAGGGC
CAGTAGAACAC -> AGTAGAACACT
TGGCACAGGTC -> GGCACAGGTCG
AATCCGGTGGT -> ATCCGGTGGTG
GCGACATGCAG -> CGACATGCAGG
ACCAAATCCGG -> CCAAATCCGGT
CAGGTCGAACT -> AGGTCGAACTA
CAATCCGAGTC -> AATCCGAGTCA
ACAAGTTCCTG -> CAAGTTCCTGT
GGAATCACATG -> GAATCACATGG
TTACCCAAGGG -> TACCCAAGGGG
CTAGTAAAAAA -> TAGTAAAAAAT
CTCGGAAAAGT -> TCGGAAAAGTT
AGGCGGCGAGA -> GGCGGCGAGAT
ACAAGACCCAT -> CAAGACCCATT
TCCGCCACACA -> CCGCCACACAA
GGGGCCCCGCA -> GGGCCCCGCAT
ACATGCAGGAT -> CATGCAGGATT
TCACGACAGCG -> CACGACAGCGC
CCTCTCTCCAG -> CTCTCTCCAGA
CGAAGTTATTA -> GAAGTTATTAT
CCGTCGGATCT -> CGTCGGATCTG
TCAGCAAAAAC -> CAGCAAAAACT
TTCAAGTATCC -> TCAAGTATCCG
TGCACCTTTAT -> GCACCTTTATG
TCGATCACCTA -> CGATCACCTAT
ATATGTCTTCC -> TATGTCTTCCA
TAGCTTCTTGA -> AGCTTCTTGAA
TCCAGAGACCA -> CCAGAGACCAT
TAACGTCTCGA -> AACGTCTCGAG
CGAAATCCTCT -> GAAATCCTCTG
GGGAAAGCTGT -> GGAAAGCTGTG
ATTTGTACACT -> TTTGTACACTA
TCCTAGGCCAC -> CCTAGGCCACT
TAGGTATACAG -> AGGTATACAGA
GCTCAGAGTGT -> CTCAGAGTGTA
GGCCAACCCCA -> GCCAACCCCAC
GCCTCAACGAG -> CCTCAACGAGA
CGGACTAGAGC -> GGACTAGAGCA
TATGCGGACCC -> ATGCGGACCCA
AAATCCTCTGC -> AATCCTCTGCA
ATGATGTATAG -> TGATGTATAGC
TTGGGGTTATT -> TGGGGTTATTT
GCCATTTCGAG -> CCATTTCGAGG
CCCATTCAATC -> CCATTCAATCC
AGCGGGTTTGG -> GCGGGTTTGGG
AACGCGCGGAG -> ACGCGCGGAGC
TGGAGTGCTCA -> GGAGTGCTCAC
AAGTTATTATA -> AGTTATTATAT
CAGTAGTTCTG -> AGTAGTTCTGA
AAGGAATTAGT -> AGGAATTAGTA
CGGGGTTTGGT -> GGGGTTTGGTT
AAAAGTTCCCG -> AAAGTTCCCGT
CATATCTGGTG -> ATATCTGGTGA
GCTCACGTTTT -> CTCACGTTTTG
GGCGACAATTT -> GCGACAATTTC
GGTGGTGATAC -> GTGGTGATACA
GCAAGGAACAT -> CAAGGAACATT
GAGCCTACCCA -> AGCCTACCCAG
AAGGCTAGTGT -> AGGCTAGTGTA
TTCAGAAGGAT -> TCAGAAGGATG
CAAATTCGGCA -> AAATTCGGCAG
ATCACCTATGA -> TCACCTATGAT
ACTAAGTAACA -> CTAAGTAACAG
ATGGCGAGGGC -> TGGCGAGGGCT
GAATTAGTACG -> AATTAGTACGC
ATTTTAGTGGC -> TTTTAGTGGCA
CCGGTGGTGTG -> CGGTGGTGTGG
ATCACTTACCC -> TCACTTACCCA
TTTCGAGGTTT -> TTCGAGGTTTT
CCTACCCAGAC -> CTACCCAGACC
GTAGTGCGGAG -> TAGTGCGGAGC
TCCAATAGCAT -> CCAATAGCATA
CGACATGCAGG -> GACATGCAGGA
GCGGGTTTGGG -> CGGGTTTGGGG
TATGCTCGAGA -> ATGCTCGAGAA
ATCCGCGCATG -> TCCGCGCATGC
GCGGAGCACCA -> CGGAGCACCAT
GCCAATCCGAG -> CCAATCCGAGT
ATCACATGGGA -> TCACATGGGAC
TAGTTCTGAGG -> AGTTCTGAGGT
TGTGGAGGTGT -> GTGGAGGTGTC
AATCGTGGCCT -> ATCGTGGCCTA
CCAAATCCGGT -> CAAATCCGGTG
GGTACAAACCA -> GTACAAACCAT
GATTATGATGT -> ATTATGATGTA
GGGGTTTGGTT -> GGGTTTGGTTC
ATTAGGGACGA -> TTAGGGACGAA
CTCGCTTCCAA -> TCGCTTCCAAC
AGTCGCTTGTG -> GTCGCTTGTGG
GCTCGCTTCCA -> CTCGCTTCCAA
ATAAGGAATTA -> TAAGGAATTAG
CGACAGAGAGC -> GACAGAGAGCG
TTGCGGTTGTG -> TGCGGTTGTGC
AGTTTTTGCAA -> GTTTTTGCAAC
CACTTCCATGC -> ACTTCCATGCG
TTCCAGTTATT -> TCCAGTTATTC
GTTATTTTAGT -> TTATTTTAGTG
TAGCCCAGATG -> AGCCCAGATGA
GTTTAATCCTG -> TTTAATCCTGC
AGCAATATCCG -> GCAATATCCGG
GCTTCCAACCG -> CTTCCAACCGA
TTCGGCAGTAG -> TCGGCAGTAGT
TATATTTAGGA -> ATATTTAGGAG
GATATTACTAA -> ATATTACTAAT
ACTCGGAAAAG -> CTCGGAAAAGT
CTATGCGGACC -> TATGCGGACCC
GAGTCTCATTC -> AGTCTCATTCA
CGCAGCACGCA -> GCAGCACGCAG
AAATTCGGCAG -> AATTCGGCAGT
GACAGAGAGCG -> ACAGAGAGCGT
GACAGAGAGCG -> ACAGAGAGCGT,ACAGAGAGCGG
CGCTATCTAAG -> GCTATCTAAGG
ATGCAGGATTG -> TGCAGGATTGA
CTTATGGTTAG -> TTATGGTTAGC
GGTTTGGGGTT -> GTTTGGGGTTA
TATGGATTCCC -> ATGGATTCCCT
GTCACGATAGA -> TCACGATAGAG
CCACGGGACGG -> CACGGGACGGG
CTTCAAGTATC -> TTCAAGTATCC
CACTATGCGGA -> ACTATGCGGAC
GATGTATAGCT -> ATGTATAGCTA
ACGTCAAGGAC -> CGTCAAGGACA
GCCGGACTAGA -> CCGGACTAGAG
TTGTGGAGGTG -> TGTGGAGGTGT
ACAAGAGCTCC -> CAAGAGCTCCA
CAGGGATTAGG -> AGGGATTAGGG
AATATGACGGG -> ATATGACGGGG
CTACCTTAGGG -> TACCTTAGGGC
TTCTAAATATG -> TCTAAATATGA
ATATTACTAAT -> TATTACTAATC
TGTACACTAGT -> GTACACTAGTA
CTCGAGGGCCA -> TCGAGGGCCAG
CCGCATATCTG -> CGCATATCTGG
GGTTAGCCCAG -> GTTAGCCCAGA
GTGAACTCTGA -> TGAACTCTGAG
TATGGGGCCCC -> ATGGGGCCCCG
TTGCCAATCCG -> TGCCAATCCGA
CACGACAGCGC -> ACGACAGCGCG
GACAGCGCGAC -> ACAGCGCGACA
TGAAGTCGTTT -> GAAGTCGTTTA
TCAACGAGAGC -> CAACGAGAGCA
GCGAGGGCTCA -> CGAGGGCTCAG
CGTATGGGGCC -> GTATGGGGCCC
TGCACGTGCAC -> GCACGTGCACC
CGAGAAAGGCG -> GAGAAAGGCGG
TGATCGAAAGT -> GATCGAAAGTG
GGCCAGACGCT -> GCCAGACGCTA
GATCGAAAGTG -> ATCGAAAGTGT
ATCGATTGGCA -> TCGATTGGCAA
AGCACCATCGA -> GCACCATCGAT
TCTGTGCTCGG -> CTGTGCTCGGC
CCACTTCCATG -> CACTTCCATGC
AGCTCCAGGCT -> GCTCCAGGCTA
TCCTGGGAACG -> CCTGGGAACGT
GCCCAGATGAC -> CCCAGATGACG
TGTGGCGACAA -> GTGGCGACAAT
TGTTACCTGCA -> GTTACCTGCAT
CGCGCTAGATC -> GCGCTAGATCG
CTTTGGCGTCG -> TTTGGCGTCGA
ATACACGTCCT -> TACACGTCCTA
ATCTGTGCTCG -> TCTGTGCTCGG
TATACACGTCC -> ATACACGTCCT
ACTTTCGATAA -> CTTTCGATAAA
GTGTGAGTCTC -> TGTGAGTCTCA
TTAGCGGCAAG -> TAGCGGCAAGA
ATCGCTGTAGC -> TCGCTGTAGCT
CGACAGCGCGA -> GACAGCGCGAC
AGAGCGGATAA -> GAGCGGATAAC
GAGCAGCATGA -> AGCAGCATGAA
GGGCCATGTTA -> GGCCATGTTAC
GCTGTTGATCT -> CTGTTGATCTG
TATGGTTAGCC -> ATGGTTAGCCC
GAAAGTGTGGA -> AAAGTGTGGAA
ATGTTACCTGC -> TGTTACCTGCA
ACCTATGCAGA -> CCTATGCAGAA
TCCCTGGAAGG -> CCCTGGAAGGC
TGGTGAAAGAT -> GGTGAAAGATA
TACCGTGACCC -> ACCGTGACCCA
AAGCAATATCC -> AGCAATATCCG
CCGATATTACT -> CGATATTACTA
ATACAGCGGGT -> TACAGCGGGTT
GCGGACAGAGA -> CGGACAGAGAG
ACATGGGACCC -> CATGGGACCCG
CTAGTGTATCC -> TAGTGTATCCT
AAATCCGGTGG -> AATCCGGTGGT
CACCCAATTTG -> ACCCAATTTGC
ATCCGCCATTT -> TCCGCCATTTC
AAGTCCGTACT -> AGTCCGTACTG
TCGTTATCAGA -> CGTTATCAGAA
ACGCCCGCAGC -> CGCCCGCAGCA
CGTGACCCACA -> GTGACCCACAA
TTGCTTTACAA -> TGCTTTACAAA
GCTTTACAAAA -> CTTTACAAAAG
CCGGACTAGAG -> CGGACTAGAGC
ATTAGGTATAC -> TTAGGTATACA
GCTGGAAAACT -> CTGGAAAACTA
AGCTAGTTTTT -> GCTAGTTTTTG
GGGATTAGGGA -> GGATTAGGGAC
CCTATGATCTG -> CTATGATCTGA
GTCCACAACAT -> TCCACAACATG
CTATGATCTGA -> TATGATCTGAA
AGAAGGCCGCA -> GAAGGCCGCAT
CGTCGGATCTG -> GTCGGATCTGA
CACATGGGACC -> ACATGGGACCC
CGATTGGCAAG -> GATTGGCAAGG
GTTCTGAGGTA -> TTCTGAGGTAC
TAATCCTGCCC -> AATCCTGCCCC
TTACCGTGACC -> TACCGTGACCC
TCTGAAGTCGT -> CTGAAGTCGTT
CCCTGGAAGGC -> CCTGGAAGGCT
TAGCATTTCAG -> AGCATTTCAGA
GCAAGAAGGCC -> CAAGAAGGCCG
TATATGTTACC -> ATATGTTACCT
CAGGATTGATG -> AGGATTGATGA
TTCTGAAATCG -> TCTGAAATCGT
TCCATGCGGCC -> CCATGCGGCCA
GTTATCAGAAG -> TTATCAGAAGT
GCATCTCGATC -> CATCTCGATCT
GTGGCCTACCT -> TGGCCTACCTA
TTTTGTGTTGA -> TTTGTGTTGAG
CGTCTCTAATA -> GTCTCTAATAT
AAGATAAGCTC -> AGATAAGCTCG
CAGATCTGACT -> AGATCTGACTT
CACAGGTCGAA -> ACAGGTCGAAC
AGGATTGATGA -> GGATTGATGAG
GTGGTGATACA -> TGGTGATACAT
AGTAGTCGCTT -> GTAGTCGCTTG
GATGGGAAGGA -> ATGGGAAGGAT
ATAAATACGCC -> TAAATACGCCC
TTTAGGAGACT -> TTAGGAGACTT
CATTCAACTTT -> ATTCAACTTTC
TGAGGGAGCCT -> GAGGGAGCCTC
TAATCGCGTAT -> AATCGCGTATG
CCACTGCCGGA -> CACTGCCGGAC
TTTTTGCAACT -> TTTTGCAACTC
CATTACGGCGA -> ATTACGGCGAT
GGCTAACGCAC -> GCTAACGCACG
TCATTGCCCTG -> CATTGCCCTGG
GCAGTAGAACA -> CAGTAGAACAC
AATAAGGAATT -> ATAAGGAATTA
GTCTCTAATAT -> TCTCTAATATG
ATACAGAATGG -> TACAGAATGGC
GACGGGGGGGA -> ACGGGGGGGAA
ACACTTAGCTT -> CACTTAGCTTC
GGATAAACAAG -> GATAAACAAGT
ATTACTAATCG -> TTACTAATCGC
TTGGCGTCGAA -> TGGCGTCGAAG
TCGCTTGTGGA -> CGCTTGTGGAG
AGGCTTAGCGG -> GGCTTAGCGGC
TGTGATCGTTA -> GTGATCGTTAT
GGCCGCATGCC -> GCCGCATGCCA
CGCATCTCGAT -> GCATCTCGATC
ATCCCGAATCG -> TCCCGAATCGC
TCAATAGCTAC -> CAATAGCTACG
CACGTCTAACG -> ACGTCTAACGC
TTCGATAAACC -> TCGATAAACCT
TCCACGGGACG -> CCACGGGACGG
TCGCGTCAATA -> CGCGTCAATAG
ATTCATTGCCC -> TTCATTGCCCT
AGCGCGACATG -> GCGCGACATGC
GGCGGCGAGAT -> GCGGCGAGATT
ACCCATGAGGG -> CCCATGAGGGA
ACACGTCCTAG -> CACGTCCTAGG
CGCTAGATCGT -> GCTAGATCGTA
CCCGAGGCACA -> CCGAGGCACAG
GATTAGGGACG -> ATTAGGGACGA
GACAATTTCCT -> ACAATTTCCTG
GTGTGGCGACA -> TGTGGCGACAA
CAGCAAGCTAT -> AGCAAGCTATT
TTAGTACGCGG -> TAGTACGCGGA
CATTCAATCCA -> ATTCAATCCAC
GGTTTGGTTCC -> GTTTGGTTCCC
CAGAGAGCGGA -> AGAGAGCGGAT
ACGAGCCCGAG -> CGAGCCCGAGG
GAAGGATGGGA -> AAGGATGGGAA
ACAGGTCGAAC -> CAGGTCGAACT
TTATGGATTCC -> TATGGATTCCC
CGACAATTTCC -> GACAATTTCCT
GTAAAAAATAC -> TAAAAAATACA
TGATGTATAGC -> GATGTATAGCT
AAGTTACCGTG -> AGTTACCGTGA
GAACTATATGT -> AACTATATGTT
AAGGGCTAACG -> AGGGCTAACGC
AGAGCAGCATG -> GAGCAGCATGA
TGCGGTTGCCA -> GCGGTTGCCAA
AGAAATTGGGT -> GAAATTGGGTG
TGATACATTAC -> GATACATTACG
GTAGCATTTCA -> TAGCATTTCAG
GATTGATGAGT -> ATTGATGAGTC
TAAAAAATACA -> AAAAAATACAG
CGTTTAATCCT -> GTTTAATCCTG
TGCCTCTCTCC -> GCCTCTCTCCA
TAAGCAATATC -> AAGCAATATCC
GTTATTCCGCC -> TTATTCCGCCA
AAGGACACGGG -> AGGACACGGGG
CGCAGTAGAAC -> GCAGTAGAACA
GTTCACATGGG -> TTCACATGGGA
CAGGGCTGTTG -> AGGGCTGTTGA
GATCGTGGACG -> ATCGTGGACGT
GATACCCTCGC -> ATACCCTCGCG
AATAGCTACGT -> ATAGCTACGTG
AACCACTTATA -> ACCACTTATAC
TAATATGTCTT -> AATATGTCTTC
AAGCCAAATTC -> AGCCAAATTCG
ACTATGCGGAC -> CTATGCGGACC
AAAGTTCCCGT -> AAGTTCCCGTC
TAGCTACGTGA -> AGCTACGTGAA
CTAAATATGAC -> TAAATATGACG
GTTTGGTTCCC -> TTTGGTTCCCA
GAATAGGGTAA -> AATAGGGTAAG
GCGAAGTTATT -> CGAAGTTATTA
GTATCCTCTTT -> TATCCTCTTTG
GCGCACTATGC -> CGCACTATGCG
AAGTTCCCGTC -> AGTTCCCGTCG
GAGGGCCAGAC -> AGGGCCAGACG
CGTCGAAGGCA -> GTCGAAGGCAG
GATCTGACTTC -> ATCTGACTTCA
GATCTATTCTA -> ATCTATTCTAA
CGAGGCACAGC -> GAGGCACAGCA
AATCCTCTGCA -> ATCCTCTGCAT
ATCCGGTGGTG -> TCCGGTGGTGT
CTCTCTCCAGA -> TCTCTCCAGAG
TTATGATGTAT -> TATGATGTATA
GCACGTCTAAC -> CACGTCTAACG
TCGACGACGGT -> CGACGACGGTA
ATTTCGAGGTT -> TTTCGAGGTTT
GGTGAAAGATA -> GTGAAAGATAA
CCTAGGCCACT -> CTAGGCCACTT
ACGGGACGGGG -> CGGGACGGGGT
TCACGTTTTGT -> CACGTTTTGTG
AGGAGGGCCAC -> GGAGGGCCACT
ATTTCCTGACT -> TTTCCTGACTT
GCAAAAACTCG -> CAAAAACTCGA
AATCCGCAAGA -> ATCCGCAAGAA
ATGGGAAGGAT -> TGGGAAGGATA
CGGATAGTTCT -> GGATAGTTCTA
AGGTGTCTAGG -> GGTGTCTAGGG
CACGTGCACCT -> ACGTGCACCTT
GTCCAGATCTG -> TCCAGATCTGA
GTTGAGACAAG -> TTGAGACAAGA
ACACTAGTAAA -> CACTAGTAAAA
TAGTTCTACTT -> AGTTCTACTTA
ACTCCGCGAAG -> CTCCGCGAAGT
GCGATCGTGGA -> CGATCGTGGAC
CAAAAGGCTTA -> AAAAGGCTTAG
ACCCCACGCTT -> CCCCACGCTTT
GGCCACTTCCA -> GCCACTTCCAT
TGGATTCCCTG -> GGATTCCCTGG
TCCTGACTTGC -> CCTGACTTGCA
GTGTATCCTCT -> TGTATCCTCTT
AGTGCGGAGCA -> GTGCGGAGCAC
CTCGAGAAAGG -> TCGAGAAAGGC
CTATGCTCGAG -> TATGCTCGAGA
ACGCAGGGATT -> CGCAGGGATTA
TTAGCCCAGAT -> TAGCCCAGATG
TGAAATCGTGG -> GAAATCGTGGC
AGGATAAACAA -> GGATAAACAAG
ACTGCCGGACT -> CTGCCGGACTA
AGTCACGATAG -> GTCACGATAGA
TGCGGCCAACC -> GCGGCCAACCC
CTCCCGCGATT -> TCCCGCGATTG
TTCCCTGGAAG -> TCCCTGGAAGG
TCGAAGGCAGG -> CGAAGGCAGGG
TAAGCTCGCAG -> AAGCTCGCAGT
TCTACTTATCT -> CTACTTATCTG
ACGTCCTGGGA -> CGTCCTGGGAA
CAGCATCCGCC -> AGCATCCGCCA
CCAGACCTATG -> CAGACCTATGC
CCATCACTTAC -> CATCACTTACC
GAGGCACAGCA -> AGGCACAGCAA
CTTGAAGCAGG -> TTGAAGCAGGA
TAAGGAATTAG -> AAGGAATTAGT
CATCCCGCATC -> ATCCCGCATCT
GCTAGTGTATC -> CTAGTGTATCC
ACGACAGCGCG -> CGACAGCGCGA
ACAGCGCGACA -> CAGCGCGACAT
CACAACATGCG -> ACAACATGCGC
CCCAGACCTAT -> CCAGACCTATG
TTTCCTGACTT -> TTCCTGACTTG
CCTCAGGGCTG -> CTCAGGGCTGT
TATTCTAAATA -> ATTCTAAATAT
AATAAGGACAG -> ATAAGGACAGT
GCTGTGATCGT -> CTGTGATCGTT
TGCTTTACAAA -> GCTTTACAAAA
ACGCGCGGAGC -> CGCGCGGAGCC
AACGTTGAATA -> ACGTTGAATAG
AAGTTCCTGTG -> AGTTCCTGTGA
GGAGTGCTCAC -> GAGTGCTCACG
AAGGATACCCT -> AGGATACCCTC
AGGAACATTTT -> GGAACATTTTG
ACGGGGTTTGG -> CGGGGTTTGGT
GCGTGCATCAC -> CGTGCATCACG
TTGATCGAAAG -> TGATCGAAAGT
TTGCCCTGGCT -> TGCCCTGGCTT
TCTGAAATCGT -> CTGAAATCGTG
AGGGCTGTTGA -> GGGCTGTTGAT
GGCAAGGAACA -> GCAAGGAACAT
ACAGAGAGCGT -> CAGAGAGCGTG
AAACCATAGTC -> AACCATAGTCA
AAGACCCATTC -> AGACCCATTCA
CGGACAGAGAG -> GGACAGAGAGC
CGCATGCCAAA -> GCATGCCAAAC
CGGTTGTGCAT -> GGTTGTGCATA
CGAACTAAGTT -> GAACTAAGTTC
TAGTCATTCAA -> AGTCATTCAAC
TCCGAGTCACA -> CCGAGTCACAC
CGGGACGGGGT -> GGGACGGGGTT
GGAAGGATACC -> GAAGGATACCC
TAAGGACAGTT -> AAGGACAGTTC
AGCAAGGTCCA -> GCAAGGTCCAA
TAGTGCGGAGC -> AGTGCGGAGCA
GAAAGCCTGTA -> AAAGCCTGTAG
ACGCCACGGTT -> CGCCACGGTTG
CGATCACCTAT -> GATCACCTATG
ATAAACAAGTT -> TAAACAAGTTC
GTTGGAGTGCT -> TTGGAGTGCTC
CACAAGACCCA -> ACAAGACCCAT
GGGGAATAAGG -> GGGAATAAGGA
GGTCCAGATCT -> GTCCAGATCTG
TTGAAAGCCAA -> TGAAAGCCAAA
ATGCGGCCAAC -> TGCGGCCAACC
GAGACCATCAC -> AGACCATCACT
AATATCCGGAT -> ATATCCGGATA
TAGTGTATCCT -> AGTGTATCCTC
GTTCTCCCGCG -> TTCTCCCGCGA
TTCGAGGTTTT -> TCGAGGTTTTA
TGGTGATACAT -> GGTGATACATT
CTCGCGTCAAT -> TCGCGTCAATA
TCCTCTGCATT -> CCTCTGCATTT
GCCTCTCTCCA -> CCTCTCTCCAG
ATCTGGTGAAA -> TCTGGTGAAAG
AGAAGGCGCTG -> GAAGGCGCTGG
ATAGGGTAAGC -> TAGGGTAAGCA
AAAACTCGAAA -> AAACTCGAAAT
ATCTAAGGTCG -> TCTAAGGTCGA
AGTGTATCAGC -> GTGTATCAGCA
CGGTTGCGGTT -> GGTTGCGGTTG
AACCAACAGCA -> ACCAACAGCAT
GCCAAATTCGG -> CCAAATTCGGC
TTACAGCAAGC -> TACAGCAAGCT
CAGAAGGGCTA -> AGAAGGGCTAA
CTATCGATTGG -> TATCGATTGGC
CGGGTGCACAA -> GGGTGCACAAT
TCTCTAATATG -> CTCTAATATGT
AACCATAGTCA -> ACCATAGTCAT
AATCCGAGTCA -> ATCCGAGTCAC
AACCCCACGCT -> ACCCCACGCTT
GCATCCGCCAT -> CATCCGCCATT
CCCATGAGGGA -> CCATGAGGGAG
GGAACGTTGAA -> GAACGTTGAAT
CTGGTGAAAGA -> TGGTGAAAGAT
TACGCCACGGT -> ACGCCACGGTT
TAGTACGCGGA -> AGTACGCGGAC
CATGCGCACTA -> ATGCGCACTAT
CACGTCCTGGG -> ACGTCCTGGGA
GTATAGCTAGT -> TATAGCTAGTT
AGTTATTCCGC -> GTTATTCCGCC
TTTGCGTCACG -> TTGCGTCACGT
TATTCCGCCAC -> ATTCCGCCACA
GCAAGGTCCAA -> CAAGGTCCAAT
ACGTCCTAGGC -> CGTCCTAGGCC
AGAGTGTATCA -> GAGTGTATCAG
GATAGAGGTCC -> ATAGAGGTCCA
CAACATGCGCA -> AACATGCGCAC
TGAATAGGGTA -> GAATAGGGTAA
ATGTTACAGCA -> TGTTACAGCAA
GGGGAGGAGTC -> GGGAGGAGTCG
CACGTTTTGTG -> ACGTTTTGTGT
AACTCGAAATC -> ACTCGAAATCC
GGCAGGGTAGG -> GCAGGGTAGGG
CGCGTATGGGG -> GCGTATGGGGC
GAGCCCGAGGC -> AGCCCGAGGCA
ATTAGTACGCG -> TTAGTACGCGG
ACGTCTCGAGG -> CGTCTCGAGGG
TGAAAGCCTGT -> GAAAGCCTGTA
GTTCTACTTAT -> TTCTACTTATC
TTGGCAAGGAA -> TGGCAAGGAAC
TCCACAACATG -> CCACAACATGC
GCAGAAGGGCT -> CAGAAGGGCTA
AATAAGACCTT -> ATAAGACCTTT
ACAAAAGGCTT -> CAAAAGGCTTA
TGCCAATCCGA -> GCCAATCCGAG
CACGCTTTCCA -> ACGCTTTCCAG
AACTTTCGATA -> ACTTTCGATAA
GGGGGAAAGCT -> GGGGAAAGCTG
ATTATATTACC -> TTATATTACCC
AGCGGCAAGAA -> GCGGCAAGAAT
AGTTCACATGG -> GTTCACATGGG
CATTTGTACAC -> ATTTGTACACT
GCACAGGTCGA -> CACAGGTCGAA
CGCAGGGATTA -> GCAGGGATTAG
GTGTTGAGACA -> TGTTGAGACAA
CTACCCAGACC -> TACCCAGACCT
AAGAATATAAA -> AGAATATAAAT
CACGCAGGGAT -> ACGCAGGGATT
GTTGCGGTTGT -> TTGCGGTTGTG
GGTTATTTTAG -> GTTATTTTAGT
GTGACCCACAA -> TGACCCACAAC
TTATACACGTC -> TATACACGTCC
ACGATAGAGGT -> CGATAGAGGTC
TGCCAAGTAGT -> GCCAAGTAGTC
AAACAAGTTCC -> AACAAGTTCCT
GGCACAGGTCG -> GCACAGGTCGA
TAGTTTTTGCA -> AGTTTTTGCAA
AACAAGTTCCT -> ACAAGTTCCTG
GCACCATCGAT -> CACCATCGATC
TTCTCCCGCGA -> TCTCCCGCGAT
GGGAAGGATAC -> GGAAGGATACC
CAAACCATAGT -> AAACCATAGTC
GAAGGATACCC -> AAGGATACCCT
AATTTGCCAAG -> ATTTGCCAAGT
CCACGGTTGCG -> CACGGTTGCGG
TATGTTACCTG -> ATGTTACCTGC
TCAATCCACGG -> CAATCCACGGG
CCAGAAGGCGC -> CAGAAGGCGCT
ATCGATCACCT -> TCGATCACCTA
ATGACGTGAAC -> TGACGTGAACT
CACTGTCGCTG -> ACTGTCGCTGG
ACGCTTTCCAG -> CGCTTTCCAGG
GCTAGATCGTA -> CTAGATCGTAA
TGACCCACAAC -> GACCCACAACT
TCCGCGAAGTT -> CCGCGAAGTTA
GTAACCAGAAG -> TAACCAGAAGG
TCCGTACTGCC -> CCGTACTGCCT
AATACAGCGGG -> ATACAGCGGGT
ATCTGATCACC -> TCTGATCACCA
ATGCGCACTAT -> TGCGCACTATG
CTTCCAGTTAT -> TTCCAGTTATT
CATTCATTGCC -> ATTCATTGCCC
TCCTGTGAAGC -> CCTGTGAAGCG
ATGACGGGGGG -> TGACGGGGGGG
GTCTAGGGTTG -> TCTAGGGTTGG
TGGGAAGGATA -> GGGAAGGATAC
TGTGTGAGTCT -> GTGTGAGTCTC
CACGGTTGCGG -> ACGGTTGCGGT
CGGTGGTGTGG -> GGTGGTGTGGC
GCCCCGTTGAT -> CCCCGTTGATC
CCAGACGCTAT -> CAGACGCTATC
AGGCGCTGGAA -> GGCGCTGGAAA
GTTGAATAGGG -> TTGAATAGGGT
GTGTCTAGGGT -> TGTCTAGGGTT
ATGCACTCGGA -> TGCACTCGGAA
TGTGGAAAAAT -> GTGGAAAAATC
CAGTTCACATG -> AGTTCACATGG
GAACATTTTGA -> AACATTTTGAA
CCGCAAGAAGG -> CGCAAGAAGGC
GAGCAACCAAA -> AGCAACCAAAT
GCTACGTGAAC -> CTACGTGAACG
GGGTGCACAAT -> GGTGCACAATT
AAATACGCCCG -> AATACGCCCGC
CAGAAGGCGCT -> AGAAGGCGCTG
TCTACGCCACG -> CTACGCCACGG
CCGCATGCCAA -> CGCATGCCAAA
AAAAACTCGAA -> AAAACTCGAAA
TGTTGATCTGT -> GTTGATCTGTG
GGTGTCTAGGG -> GTGTCTAGGGT
AAGTATCCGCG -> AGTATCCGCGC
CTATTCTAAAT -> TATTCTAAATA
CTTGCACGTGC -> TTGCACGTGCA
AAGGCTTAGCG -> AGGCTTAGCGG
TGTCGCTGGCA -> GTCGCTGGCAC
GGAGACTTCTA -> GAGACTTCTAC
TCCGGATAGTT -> CCGGATAGTTC
AATGCACTCGG -> ATGCACTCGGA
CAATTAAATGC -> AATTAAATGCA
TCTTTGCGTCA -> CTTTGCGTCAC
CTCAGAGTGTA -> TCAGAGTGTAT
CCCCACGCTTT -> CCCACGCTTTC
AGCCAAATTCG -> GCCAAATTCGG
AACCAGAAGGC -> ACCAGAAGGCG
TACAGCGGGTT -> ACAGCGGGTTT
AAGCGCACGTC -> AGCGCACGTCT
GATCTGTGCTC -> ATCTGTGCTCG
CACGTCCTAGG -> ACGTCCTAGGC
TTAGGAGACTT -> TAGGAGACTTC
GCATGAATTGA -> CATGAATTGAA
ACGAGAGCAAC -> CGAGAGCAACC
GGGAACGTTGA -> GGAACGTTGAA
CACCTTTATGG -> ACCTTTATGGA
ACGTCAATCCG -> CGTCAATCCGC
CATCTCGATCT -> ATCTCGATCTT
ACCACTTATAC -> CCACTTATACA
GCTCGGCCTCA -> CTCGGCCTCAA
GTCACGTCAAG -> TCACGTCAAGG
CTAATCGCGTA -> TAATCGCGTAT
ATAGCATATAT -> TAGCATATATT
AGCTTATGGTT -> GCTTATGGTTA
GCATTTGTACA -> CATTTGTACAC
CATCACTTACC -> ATCACTTACCC
TCGTGGACGTC -> CGTGGACGTCA
TCTAAGGTCGA -> CTAAGGTCGAA
CTTTATGGATT -> TTTATGGATTC
ACGGGGGGGAA -> CGGGGGGGAAA
AGAGCGTGCAT -> GAGCGTGCATC
GTCGAACTATA -> TCGAACTATAT
GGGAATAAGGA -> GGAATAAGGAA
TGGCGAGGGCT -> GGCGAGGGCTC
TGAGTCACGAT -> GAGTCACGATA
GGGACGGGGTT -> GGACGGGGTTT
TGGCAAGGAAC -> GGCAAGGAACA
CTTAGCTTCTT -> TTAGCTTCTTG
GGCACAGCAAG -> GCACAGCAAGG
GCAACCAAATC -> CAACCAAATCC
GCAGGATTGAT -> CAGGATTGATG
GTTGATCTGTG -> TTGATCTGTGC
ATGAATTGAAA -> TGAATTGAAAG
AGAGCTCCAGG -> GAGCTCCAGGC
GAGTCACGATA -> AGTCACGATAG
TACAAAAGGCT -> ACAAAAGGCTT
TTATTCCGCCA -> TATTCCGCCAC
CATGGGACGGG -> ATGGGACGGGT
GTGCGGAGCAC -> TGCGGAGCACC
CACGATAGAGG -> ACGATAGAGGT
AGACGCTATCT -> GACGCTATCTA
GTTACCTGCAT -> TTACCTGCATC
TATCGATTGGC -> ATCGATTGGCA
GGAAAGCTGTG -> GAAAGCTGTGA
GCTCGACGACG -> CTCGACGACGG
TGCACAATTAA -> GCACAATTAAA
CCAGGCTATGC -> CAGGCTATGCT
TCCAGGCTATG -> CCAGGCTATGC
CTCGAAATCCT -> TCGAAATCCTC
CACGTCAAGGA -> ACGTCAAGGAC
ACGGGTGCACA -> CGGGTGCACAA
TACCTATCGAT -> ACCTATCGATT
TGGGGCCCCGC -> GGGGCCCCGCA
AAAGTGTGGAA -> AAGTGTGGAAA
CCCAAGGGGAA -> CCAAGGGGAAT
ACCTTTGGCGT -> CCTTTGGCGTC
TGGGACGGGTG -> GGGACGGGTGC
AGGTCCAGATC -> GGTCCAGATCT
TTTATGGATTC -> TTATGGATTCC
AGCAAAAACTC -> GCAAAAACTCG
AGCTGTGATCG -> GCTGTGATCGT
CAATAGCATAT -> AATAGCATATA
GGACGGGTGCA -> GACGGGTGCAC
CGGCCAACCCC -> GGCCAACCCCA
ATGCAAGTTAC -> TGCAAGTTACC
GACTTGCACGT -> ACTTGCACGTG
CTGGAAGGCTA -> TGGAAGGCTAG
CCGCATCTCGA -> CGCATCTCGAT
CCAGAGACCAT -> CAGAGACCATC
GCACGAGCCCG -> CACGAGCCCGA
GACGACGGTAG -> ACGACGGTAGC
GTGAGTCTCAT -> TGAGTCTCATT
TGGGTGGTGAT -> GGGTGGTGATA
GTCAAGGACAC -> TCAAGGACACG
ACCCTCGCGTC -> CCCTCGCGTCA
AAGTAACAGAA -> AGTAACAGAAA
GTGGCGACAAT -> TGGCGACAATT
GAAGGCTAGTG -> AAGGCTAGTGT
GCCATGTTACA -> CCATGTTACAG
TGCATACCCGC -> GCATACCCGCG
AGGGATTAGGG -> GGGATTAGGGA
ATCCGGATAGT -> TCCGGATAGTT
TCATTCAACTT -> CATTCAACTTT
ACACGTCCTGG -> CACGTCCTGGG
GTCCGTACTGC -> TCCGTACTGCC
CGTCCTAGGCC -> GTCCTAGGCCA
GGTTGCCAATC -> GTTGCCAATCC
AGTAACAGAAA -> GTAACAGAAAT
CGCTTTCCAGG -> GCTTTCCAGGA
ACTATATGTTA -> CTATATGTTAC
TTCGGGGTCCA -> TCGGGGTCCAC
CCCCGCGCTAG -> CCCGCGCTAGA
ACGCTATCTAA -> CGCTATCTAAG
CCGCCATTTCG -> CGCCATTTCGA
GTGCACAATTA -> TGCACAATTAA
GTGAAGCGCAC -> TGAAGCGCACG
TAAACAAGTTC -> AAACAAGTTCC
CAAGACCCATT -> AAGACCCATTC
TCTAACGCGCG -> CTAACGCGCGG
GGAATAAGGAA -> GAATAAGGAAT
CCTCCGTCTCT -> CTCCGTCTCTA
GCTCCAGGCTA -> CTCCAGGCTAT
GAAGTTCTCCC -> AAGTTCTCCCG
GAGTGCTCACG -> AGTGCTCACGT
AGGTATACAGA -> GGTATACAGAA
TCAGAGTGTAT -> CAGAGTGTATC
CGCATGCGGTT -> GCATGCGGTTG
TTTCGATAAAC -> TTCGATAAACC
GGCTTTCTGAA -> GCTTTCTGAAA
CGGCGAGATTT -> GGCGAGATTTC
GAAGGCGCTGG -> AAGGCGCTGGA
TGAGACAAGAG -> GAGACAAGAGC
CATGCGGCCAA -> ATGCGGCCAAC
ATGATCTGAAG -> TGATCTGAAGT
TGCATCCCGCA -> GCATCCCGCAT
TTTGGGGTTAT -> TTGGGGTTATT
CAGGATAAACA -> AGGATAAACAA
TTAGTGGCACC -> TAGTGGCACCC
CGTTATCAGAA -> GTTATCAGAAG
GGTCGAACTAT -> GTCGAACTATA
CGCACGTCTAA -> GCACGTCTAAC
GCAGTAGTTCT -> CAGTAGTTCTG
CCCGTTGATCG -> CCGTTGATCGA
TACACTAGTAA -> ACACTAGTAAA
TGGCCTACCTA -> GGCCTACCTAC
GCGGTTGTGCA -> CGGTTGTGCAT
AGAAAGGCGGC -> GAAAGGCGGCG
CCTGCATCCCG -> CTGCATCCCGC
CGCCATTTCGA -> GCCATTTCGAG
ACAAACCATAG -> CAAACCATAGT
GAACTCTGAGT -> AACTCTGAGTG
CTCTCCAGAGA -> TCTCCAGAGAC
TTACAAAAGGC -> TACAAAAGGCT
CAATATCCGGA -> AATATCCGGAT
AATCGCGTATG -> ATCGCGTATGG
ATAGCTACGTG -> TAGCTACGTGA
CTCAGGGCTGT -> TCAGGGCTGTT
TCAGAAGTTCT -> CAGAAGTTCTC
ACTGTCGCTGG -> CTGTCGCTGGC
AGTATCCGCGC -> GTATCCGCGCA
CTATTAGGTAT -> TATTAGGTATA
TTGCCAAGTAG -> TGCCAAGTAGT
ATGTATAGCTA -> TGTATAGCTAG
ACTTACCCAAG -> CTTACCCAAGG
CGATTGCTTTA -> GATTGCTTTAC
TGGCGACAATT -> GGCGACAATTT
GGCCTCAACGA -> GCCTCAACGAG
GGAGCCTCAGG -> GAGCCTCAGGG
ATAACGTCTCG -> TAACGTCTCGA
TATTTAGGAGA -> ATTTAGGAGAC
GTTTGGGGTTA -> TTTGGGGTTAT
AGCTTCTTGAA -> GCTTCTTGAAG
TACCCAAGGGG -> ACCCAAGGGGA
AGCATATATTT -> GCATATATTTA
CGCGTCAATAG -> GCGTCAATAGC
ACTTAGCTTCT -> CTTAGCTTCTT
TATACAGAATG -> ATACAGAATGG
CTTAGCGGCAA -> TTAGCGGCAAG
GGGTTGGAGTG -> GGTTGGAGTGC
AGACCTTTGGC -> GACCTTTGGCG
TAAGTTCGGGG -> AAGTTCGGGGT
TAGCATATATT -> AGCATATATTT
CCGTTGATCGA -> CGTTGATCGAA
AGGGACGAAGC -> GGGACGAAGCT
GACTAGAGCAG -> ACTAGAGCAGC
GGGGATGCAAG -> GGGATGCAAGT
TTTACAAAAGG -> TTACAAAAGGC
CCCCGTTGATC -> CCCGTTGATCG
GCCTACCTACC -> CCTACCTACCT
CATTGCCCTGG -> ATTGCCCTGGC
AAATATGACGG -> AATATGACGGG
GTGCTCACGTT -> TGCTCACGTTT
TACTTATCTGA -> ACTTATCTGAA
TCAGAAGGATG -> CAGAAGGATGG
GTTCCCAAGGA -> TTCCCAAGGAA
ATCCGCAAGAA -> TCCGCAAGAAG
AGACTTCTACG -> GACTTCTACGC
CTGTGATCGTT -> TGTGATCGTTA
CCGTGACCCAC -> CGTGACCCACA
CCAACCGATAT -> CAACCGATATT
CCATGCGGCCA -> CATGCGGCCAA
TGTATCAGCAA -> GTATCAGCAAA
TATGATGTATA -> ATGATGTATAG
CTGCCCCGTTG -> TGCCCCGTTGA
AGCATGAATTG -> GCATGAATTGA
TCAAGTATCCG -> CAAGTATCCGC
CGCACTATGCG -> GCACTATGCGG
GGTGGTGTGGC -> GTGGTGTGGCG
GTTACAGCAAG -> TTACAGCAAGC
GAAGCTCGCTT -> AAGCTCGCTTC
GCCTGTAGTGC -> CCTGTAGTGCG
AATTAGTACGC -> ATTAGTACGCG
GATAAACCTCC -> ATAAACCTCCG
ACCATCACTTA -> CCATCACTTAC
CCACAACATGC -> CACAACATGCG
TGGAAGGCTAG -> GGAAGGCTAGT
CCCGCATCTCG -> CCGCATCTCGA
ATTCAATCCAC -> TTCAATCCACG
GGGCCAGACGC -> GGCCAGACGCT
GTCGGATTATG -> TCGGATTATGA
AAGCTCGCAGT -> AGCTCGCAGTA
GTTCCTGTGAA -> TTCCTGTGAAG
AAGACCTTTGG -> AGACCTTTGGC
AGTTCTACTTA -> GTTCTACTTAT
TGTGCTCGGCC -> GTGCTCGGCCT
AACAGAAATTG -> ACAGAAATTGG
CGTCCTGGGAA -> GTCCTGGGAAC
ATCGCGTATGG -> TCGCGTATGGG
TGCAACTCCGC -> GCAACTCCGCG
GTCGTTTAATC -> TCGTTTAATCC
TAGTCGCTTGT -> AGTCGCTTGTG
GCTTGTGGAGG -> CTTGTGGAGGT
GCCGCATGCCA -> CCGCATGCCAA
GATACATTACG -> ATACATTACGG
AACCGATATTA -> ACCGATATTAC
CCAACAGCATC -> CAACAGCATCC
GACCCACAACT -> ACCCACAACTA
TGAACTCTGAG -> GAACTCTGAGT
TCGAAAGTGTG -> CGAAAGTGTGG
GCAGGGTAGGG -> CAGGGTAGGGG
AAGGCGGCGAG -> AGGCGGCGAGA
AGAGCAACCAA -> GAGCAACCAAA
GACGAAGCTCG -> ACGAAGCTCGC
AGCTCGCAGTA -> GCTCGCAGTAG
ATAGTTCTACT -> TAGTTCTACTT
GTCGAAGGCAG -> TCGAAGGCAGG
CACGAGCCCGA -> ACGAGCCCGAG
AGTTATTATAT -> GTTATTATATT
AACATTTTGAA -> ACATTTTGAAA
TTGCGTCACGT -> TGCGTCACGTC
GGAGGTGTCTA -> GAGGTGTCTAG
ACCCGAGTGAA -> CCCGAGTGAAT
CATTTCAGAAG -> ATTTCAGAAGG
GGTGCACAATT -> GTGCACAATTA
GCAGGGATTAG -> CAGGGATTAGG
GTTTTACCTAT -> TTTTACCTATC
GATGCAAGTTA -> ATGCAAGTTAC
CCGAGTGAATA -> CGAGTGAATAA
GTGTGGAAAAA -> TGTGGAAAAAT
GCAAGAATATA -> CAAGAATATAA
CTTATCTGAAG -> TTATCTGAAGT
GACCTTTGGCG -> ACCTTTGGCGT
CCTACCTACCT -> CTACCTACCTT
GCTTCTTGAAG -> CTTCTTGAAGC
TGGCTTTCTGA -> GGCTTTCTGAA
GGGACGAAGCT -> GGACGAAGCTC
AAGCTCGCTTC -> AGCTCGCTTCC
AGTCCGTACTG -> GTCCGTACTGC
GAGCGTGCATC -> AGCGTGCATCA
ACAGCATCCGC -> CAGCATCCGCC
TAAATACGCCC -> AAATACGCCCG
CTAGATCGTAA -> TAGATCGTAAC
TGGACGTCAAT -> GGACGTCAATC
CGCACGAGCCC -> GCACGAGCCCG
CCCGAGTGAAT -> CCGAGTGAATA
ACAACATGCGC -> CAACATGCGCA
GGTTTTACCTA -> GTTTTACCTAT
GCAACTCCGCG -> CAACTCCGCGA
CTGCCTCTCTC -> TGCCTCTCTCC
AGTTCGGGGTC -> GTTCGGGGTCC
CGCCACGGTTG -> GCCACGGTTGC
CTCAACGAGAG -> TCAACGAGAGC
AATCCACGGGA -> ATCCACGGGAC
ACTAGAGCAGC -> CTAGAGCAGCA
CTCATTCATTG -> TCATTCATTGC
TATCTAAGGTC -> ATCTAAGGTCG
GTCTCATTCAT -> TCTCATTCATT
ACGACAGAGAG -> CGACAGAGAGC
ATTGGCAAGGA -> TTGGCAAGGAA
CCGAGTCACAC -> CGAGTCACACG
GAAGTCGTTTA -> AAGTCGTTTAA
GGGGGGAAAGC -> GGGGGAAAGCT
GAACGACAGAG -> AACGACAGAGA
TGACTTGCACG -> GACTTGCACGT
GTATCAGCAAA -> TATCAGCAAAA
AGCGGATAACG -> GCGGATAACGT
TTACCTGCATC -> TACCTGCATCC
CCAGGAGGGCC -> CAGGAGGGCCA
GGGTGGTGATA -> GGTGGTGATAC
TATATTACCCC -> ATATTACCCCG
TATGACGGGGG -> ATGACGGGGGG
TATTATATTAC -> ATTATATTACC
GTTCGGGGTCC -> TTCGGGGTCCA
GGTTGCGGTTG -> GTTGCGGTTGT
GAAAACTAAGT -> AAAACTAAGTA
AAAGATAAGCT -> AAGATAAGCTC
GTAACAGAAAT -> TAACAGAAATT
ACTCTGAGTGG -> CTCTGAGTGGG
CGACGGTAGCA -> GACGGTAGCAT
AATAGGGTAAG -> ATAGGGTAAGC
TAGGGGATGCA -> AGGGGATGCAA
AAGTGTGGAAA -> AGTGTGGAAAA
ATGCGGTTGCC -> TGCGGTTGCCA
GCACGCAGGGA -> CACGCAGGGAT
GCCAGACGCTA -> CCAGACGCTAT
GCAGGATAAAC -> CAGGATAAACA
AGGCTATGCTC -> GGCTATGCTCG
AGGCACAGCAA -> GGCACAGCAAG
AGGAATTAGTA -> GGAATTAGTAC
TGCTCGAGAAA -> GCTCGAGAAAG
AAATCCCGAAT -> AATCCCGAATC
ATCTGACTTCA -> TCTGACTTCAA
CGAGATTTCAA -> GAGATTTCAAA
TTAGGGCCATG -> TAGGGCCATGT
GATGAGTCACG -> ATGAGTCACGA
AGTCGGATTAT -> GTCGGATTATG
CGCATATCTGG -> GCATATCTGGT
GTGGACGTCAA -> TGGACGTCAAT
CCGCGCTAGAT -> CGCGCTAGATC
GCGTCAATAGC -> CGTCAATAGCT
GACGTGAACTC -> ACGTGAACTCT
TCCAACCGATA -> CCAACCGATAT
GCGCTAGATCG -> CGCTAGATCGT
TCCCGTCGGAT -> CCCGTCGGATC
TAAATATGACG -> AAATATGACGG
CTTCTTGAAGC -> TTCTTGAAGCA
GATCGTAACCA -> ATCGTAACCAG
GGTTGTGCATA -> GTTGTGCATAC
CCAAGGGGAAT -> CAAGGGGAATA
GAGGTTTTACC -> AGGTTTTACCT
TTGGGTGGTGA -> TGGGTGGTGAT
ATTGATGAGTC -> TTGATGAGTCA
CTTAGGGCCAT -> TTAGGGCCATG
CGAACCACTTA -> GAACCACTTAT
ACATTTTGAAA -> CATTTTGAAAG
TCGTTTAATCC -> CGTTTAATCCT
GAAAAATCCCG -> AAAAATCCCGA
CGGAAAAGTTC -> GGAAAAGTTCC
GGCTCGACGAC -> GCTCGACGACG
CGAGGGCCAGA -> GAGGGCCAGAC
GCACTATGCGG -> CACTATGCGGA
ATACGCCCGCA -> TACGCCCGCAG
CCATCGATCAC -> CATCGATCACC
AATATGTCTTC -> ATATGTCTTCC
CCAAACCAACA -> CAAACCAACAG
CGTCACGTCAA -> GTCACGTCAAG
CATATATTTAG -> ATATATTTAGG
TACCTACCTTA -> ACCTACCTTAG
ATGCCAAACCA -> TGCCAAACCAA
GCTTTCCAGGA -> CTTTCCAGGAG
GGATCTATTCT -> GATCTATTCTA
CACGGGGAGGA -> ACGGGGAGGAG
TATCAGCAAAA -> ATCAGCAAAAA
ACAGAAATTGG -> CAGAAATTGGG
ACAGTTCACAT -> CAGTTCACATG
CGGCAGTAGTT -> GGCAGTAGTTC
GTGGTGTGGCG -> TGGTGTGGCGA
CAGATGACGTG -> AGATGACGTGA
CTTATACACGT -> TTATACACGTC
TCTCGAGGGCC -> CTCGAGGGCCA
AAGTCGTTTAA -> AGTCGTTTAAT
TGCGGAGCACC -> GCGGAGCACCA
GGGCCCCGCAT -> GGCCCCGCATA
AGGAATCACAT -> GGAATCACATG
AGTGTGGAAAA -> GTGTGGAAAAA
GCCACGGTTGC -> CCACGGTTGCG
ACCCAAGGGGA -> CCCAAGGGGAA
TGCAGAAGGGC -> GCAGAAGGGCT
CGTTTTGTGTT -> GTTTTGTGTTG
GAGATTTCAAA -> AGATTTCAAAT
AACTAAGTTCG -> ACTAAGTTCGG
TAGAGCAGCAT -> AGAGCAGCATG
ATTGGGTGGTG -> TTGGGTGGTGA
TAGTGGCACCC -> AGTGGCACCCA
GTGGCACCCAA -> TGGCACCCAAT
CCTCTTTGCGT -> CTCTTTGCGTC
TAAATGCACTC -> AAATGCACTCG
TGGGATCTATT -> GGGATCTATTC
ATTCTAAATAT -> TTCTAAATATG
ATGGTTAGCCC -> TGGTTAGCCCA
AGTCGTTTAAT -> GTCGTTTAATC
CTCCAGAGACC -> TCCAGAGACCA
GGGCCACTGTC -> GGCCACTGTCG
CGTACTGCCTC -> GTACTGCCTCT
GGGTTTGGGGT -> GGTTTGGGGTT
GCTAGTTTTTG -> CTAGTTTTTGC
GTCGAACCACT -> TCGAACCACTT
ATCGTGGCCTA -> TCGTGGCCTAC
CGGGGTCCACA -> GGGGTCCACAA
AGACCCATTCA -> GACCCATTCAA
CAAATCCGGTG -> AAATCCGGTGG
GGGACCCGAGT -> GGACCCGAGTG
GTCTTCCAGTT -> TCTTCCAGTTA
CTCGGCCTCAA -> TCGGCCTCAAC
TGCATCACGAC -> GCATCACGACA
CCACTTATACA -> CACTTATACAC
ATCTCGATCTT -> TCTCGATCTTT
CAAGAATATAA -> AAGAATATAAA
GGAGTCGGATT -> GAGTCGGATTA
CCAAATTCGGC -> CAAATTCGGCA
TCTCCAGAGAC -> CTCCAGAGACC
CCGAATCGCTG -> CGAATCGCTGT
CGAGCCCGAGG -> GAGCCCGAGGC
TTACCTATCGA -> TACCTATCGAT
TCGGAAAAGTT -> CGGAAAAGTTC
GGAAAAATCCC -> GAAAAATCCCG
GTGGAAAAATC -> TGGAAAAATCC
TTCTGAGGTAC -> TCTGAGGTACA
GTAGGGGATGC -> TAGGGGATGCA
TTCTACGCCAC -> TCTACGCCACG
GGATGCAAGTT -> GATGCAAGTTA
AAACTCGAAAT -> AACTCGAAATC
GATTGCTTTAC -> ATTGCTTTACA
TCCCAAGGAAT -> CCCAAGGAATC
TGTGCATACCC -> GTGCATACCCG
GTTGATCGAAA -> TTGATCGAAAG
GTACGCGGACA -> TACGCGGACAG
GGATCTGATCA -> GATCTGATCAC
ACCCAATTTGC -> CCCAATTTGCC
TCCGCCATTTC -> CCGCCATTTCG
AACGAGAGCAA -> ACGAGAGCAAC
TCTTGAAGCAG -> CTTGAAGCAGG
TATCAGAAGTT -> ATCAGAAGTTC
AGGTCCAATAG -> GGTCCAATAGC
AATTCGGCAGT -> ATTCGGCAGTA
ACCCCGCGCTA -> CCCCGCGCTAG
AAACCTCCGTC -> AACCTCCGTCT
GTTACCGTGAC -> TTACCGTGACC
CTTTACAAAAG -> TTTACAAAAGG
CTGTAGTGCGG -> TGTAGTGCGGA
TAGAGGTCCAG -> AGAGGTCCAGA
GAAAGCCAAAT -> AAAGCCAAATT
AAATACAGCGG -> AATACAGCGGG
GCTATGCTCGA -> CTATGCTCGAG
TGATCTGTGCT -> GATCTGTGCTC
GGGTCCACAAC -> GGTCCACAACA
GGGGTCCACAA -> GGGTCCACAAC
ATTAAATGCAC -> TTAAATGCACT
CAGGAGGGCCA -> AGGAGGGCCAC
CCACGCTTTCC -> CACGCTTTCCA
TTTAATCCTGC -> TTAATCCTGCC
GCAAGCTATTA -> CAAGCTATTAG
CCGCGCATGCG -> CGCGCATGCGG
ATAAGGACAGT -> TAAGGACAGTT
GTACTGCCTCT -> TACTGCCTCTC
GAAGTTATTAT -> AAGTTATTATA
AGGGCTAACGC -> GGGCTAACGCA
TGCCCTGGCTT -> GCCCTGGCTTT
TTCCAACCGAT -> TCCAACCGATA
AAACCAACAGC -> AACCAACAGCA
CACACGTCCTG -> ACACGTCCTGG
CCTATCGATTG -> CTATCGATTGG
GGAAGGCTAGT -> GAAGGCTAGTG
TATTAGGTATA -> ATTAGGTATAC
GCGATTGCTTT -> CGATTGCTTTA
GAGAGCGGATA -> AGAGCGGATAA
TATCCGCGCAT -> ATCCGCGCATG
TTTGGTTCCCA -> TTGGTTCCCAA
GGATTGATGAG -> GATTGATGAGT
TCGGGCTCGAC -> CGGGCTCGACG
GTCAATCCGCA -> TCAATCCGCAA
ATTATGATGTA -> TTATGATGTAT
GCAAGTTACCG -> CAAGTTACCGT
TTTTGAAAGCC -> TTTGAAAGCCA
TGATCTGAAGT -> GATCTGAAGTC
CACTTACCCAA -> ACTTACCCAAG
TCGAGAAAGGC -> CGAGAAAGGCG
GACAAGAGCTC -> ACAAGAGCTCC
AGGACAGTTCA -> GGACAGTTCAC
ACCTATCGATT -> CCTATCGATTG
TCGTGGCCTAC -> CGTGGCCTACC
CTCTGCATTTG -> TCTGCATTTGT
CTACGCCACGG -> TACGCCACGGT
ATATGTTACCT -> TATGTTACCTG
GAAAAGTTCCC -> AAAAGTTCCCG
CTTCCAACCGA -> TTCCAACCGAT
TATTACCCCGC -> ATTACCCCGCG
TCCCGCGATTG -> CCCGCGATTGC
TACAAACCATA -> ACAAACCATAG
AGCTATTAGGT -> GCTATTAGGTA
TCACCACTGCC -> CACCACTGCCG
CGGCGATCGTG -> GGCGATCGTGG
CGGGGAGGAGT -> GGGGAGGAGTC
AGTTCTGAGGT -> GTTCTGAGGTA
GCCAAACCAAC -> CCAAACCAACA
TCCAGTTATTC -> CCAGTTATTCC
AAGTTCTCCCG -> AGTTCTCCCGC
AGAATGGCGAG -> GAATGGCGAGG
GTACACTAGTA -> TACACTAGTAA
TACCTGCATCC -> ACCTGCATCCC
CGCTGGCACAG -> GCTGGCACAGG
ACGCGGACAGA -> CGCGGACAGAG
GTGCACCTTTA -> TGCACCTTTAT
TCACGTCAAGG -> CACGTCAAGGA
ATCGTGGACGT -> TCGTGGACGTC
AGCACGCAGGG -> GCACGCAGGGA
TCTGCATTTGT -> CTGCATTTGTA
ATTGAAAGCCT -> TTGAAAGCCTG
AACTCTGAGTG -> ACTCTGAGTGG
ACGTTTTGTGT -> CGTTTTGTGTT
GAGACTTCTAC -> AGACTTCTACG
ACGGGGAGGAG -> CGGGGAGGAGT
TTGTGTGAGTC -> TGTGTGAGTCT
TGGCACCCAAT -> GGCACCCAATT
TGGAGGTGTCT -> GGAGGTGTCTA
TTCCTGTGAAG -> TCCTGTGAAGC
CGTGCATCACG -> GTGCATCACGA
TTGGAGTGCTC -> TGGAGTGCTCA
TCGGCAGTAGT -> CGGCAGTAGTT
TGACTTCAAGT -> GACTTCAAGTA
TCCGTCTCTAA -> CCGTCTCTAAT
TAAGGTCGAAC -> AAGGTCGAACC
GAGGTACAAAC -> AGGTACAAACC
ATAGTCATTCA -> TAGTCATTCAA
ATAAACCTCCG -> TAAACCTCCGT
AAGAAGGCCGC -> AGAAGGCCGCA
TTACCCCGCGC -> TACCCCGCGCT
CCTGCCCCGTT -> CTGCCCCGTTG
TTTCTGAAATC -> TTCTGAAATCG
GCGAGATTTCA -> CGAGATTTCAA
CCACTGTCGCT -> CACTGTCGCTG
TAACAGAAATT -> AACAGAAATTG
CGTTGATCGAA -> GTTGATCGAAA
CCTGTGAAGCG -> CTGTGAAGCGC
TGGAAAAATCC -> GGAAAAATCCC
TCGCTGGCACA -> CGCTGGCACAG
TCTCGATCTTT -> CTCGATCTTTG
GAATCGCTGTA -> AATCGCTGTAG
CGAGTCACACG -> GAGTCACACGT
GTCGCTGGCAC -> TCGCTGGCACA
CCGCGATTGCT -> CGCGATTGCTT
CGACGACGGTA -> GACGACGGTAG
ACCTGCATCCC -> CCTGCATCCCG
TGACGGGGGGG -> GACGGGGGGGA
GTAGTCGCTTG -> TAGTCGCTTGT
AGAAGTTCTCC -> GAAGTTCTCCC
CAGCATGAATT -> AGCATGAATTG
AACATGCGCAC -> ACATGCGCACT
GGCAAGAATAT -> GCAAGAATATA
CACATGGGACG -> ACATGGGACGG
ACTAAGTTCGG -> CTAAGTTCGGG
AATCGCTGTAG -> ATCGCTGTAGC
AGAGAGCGGAT -> GAGAGCGGATA
GCCCTGGCTTT -> CCCTGGCTTTC
GACCCATGAGG -> ACCCATGAGGG
CGTGGACGTCA -> GTGGACGTCAA
GGACTAGAGCA -> GACTAGAGCAG
GCCCGAGGCAC -> CCCGAGGCACA
ATTTCAAATAA -> TTTCAAATAAG
CCAGATGACGT -> CAGATGACGTG
AGGGCTCAGAG -> GGGCTCAGAGT
CCGAGGCACAG -> CGAGGCACAGC
CAGCAAAAACT -> AGCAAAAACTC
TAACCAGAAGG -> AACCAGAAGGC
TCGAAATCCTC -> CGAAATCCTCT
CGCGGAGCCTA -> GCGGAGCCTAC
ACAATTTCCTG -> CAATTTCCTGA
TCGAACTATAT -> CGAACTATATG
GCGCGACATGC -> CGCGACATGCA
CGCTGGAAAAC -> GCTGGAAAACT
AGCCTGTAGTG -> GCCTGTAGTGC
AATATAAATAC -> ATATAAATACG
CCCAAGGAATC -> CCAAGGAATCA
TCGTAACCAGA -> CGTAACCAGAA
AAGCAGGATAA -> AGCAGGATAAA
CCGCGAACTAA -> CGCGAACTAAG
AACTCCGCGAA -> ACTCCGCGAAG
TCGAACCACTT -> CGAACCACTTA
AAAACTAAGTA -> AAACTAAGTAA
TCGAGGTTTTA -> CGAGGTTTTAC
GGCGATCGTGG -> GCGATCGTGGA
GCATCACGACA -> CATCACGACAG
ATCCTGCCCCG -> TCCTGCCCCGT
CGGACCCATGA -> GGACCCATGAG
AAATTGGGTGG -> AATTGGGTGGT
AAGAGCTCCAG -> AGAGCTCCAGG
CACTTATACAC -> ACTTATACACG
CGGCCTCAACG -> GGCCTCAACGA
GCGGTTGCCAA -> CGGTTGCCAAT
ATAAGACCTTT -> TAAGACCTTTG
ACCTTTATGGA -> CCTTTATGGAT
AGGATACCCTC -> GGATACCCTCG
ATTCGGCAGTA -> TTCGGCAGTAG
ACGTGAACTCT -> CGTGAACTCTG
TTCCTGACTTG -> TCCTGACTTGC
CGAACTATATG -> GAACTATATGT
GGATAGTTCTA -> GATAGTTCTAC
ATAGAGGTCCA -> TAGAGGTCCAG
GTGGGATCTAT -> TGGGATCTATT
CCATTCAATCC -> CATTCAATCCA
CCAATCCGAGT -> CAATCCGAGTC
GGATAACGTCT -> GATAACGTCTC
CTCCGCGAAGT -> TCCGCGAAGTT
TCGATAAACCT -> CGATAAACCTC
ATCTGAAGTCG -> TCTGAAGTCGT
GCCCCGCATAT -> CCCCGCATATC
TAACGCACGAG -> AACGCACGAGC
CATGCAGGATT -> ATGCAGGATTG
ATGCTCGAGAA -> TGCTCGAGAAA
AGTCATTCAAC -> GTCATTCAACT
AAAATACAGCG -> AAATACAGCGG
AAAAATCCCGA -> AAAATCCCGAA
CGGTTGCCAAT -> GGTTGCCAATC
GCGCTGGAAAA -> CGCTGGAAAAC
AAAGCCTGTAG -> AAGCCTGTAGT
TATCTGGTGAA -> ATCTGGTGAAA
AGAGACCATCA -> GAGACCATCAC
GAGGTGTCTAG -> AGGTGTCTAGG
GGATTAGGGAC -> GATTAGGGACG
CTTCCATGCGG -> TTCCATGCGGC
GGTAAGCAATA -> GTAAGCAATAT
CAGAGACCATC -> AGAGACCATCA
AAGGATGGGAA -> AGGATGGGAAG
AGTAGAACACT -> GTAGAACACTT
GATCGTTATCA -> ATCGTTATCAG
GAAAGGCGGCG -> AAAGGCGGCGA
GATCTGATCAC -> ATCTGATCACC
TGTAGTGCGGA -> GTAGTGCGGAG
TACTAATCGCG -> ACTAATCGCGT
GCGGCGAGATT -> CGGCGAGATTT
ACATGCGCACT -> CATGCGCACTA
GATCACCACTG -> ATCACCACTGC
ACTAATCGCGT -> CTAATCGCGTA
CCCGCGAACTA -> CCGCGAACTAA
CTGGCTTTCTG -> TGGCTTTCTGA
AGGGGATGCAA -> GGGGATGCAAG
ACCACTGCCGG -> CCACTGCCGGA
ATTTTGAAAGC -> TTTTGAAAGCC
GCGACAATTTC -> CGACAATTTCC
TTGTGCATACC -> TGTGCATACCC
ACGTGAACGAC -> CGTGAACGACA
TAGGCCACTTC -> AGGCCACTTCC
TGCAAGTTACC -> GCAAGTTACCG
AGCAGCATGAA -> GCAGCATGAAT
TATTACTAATC -> ATTACTAATCG
TCACATGGGAC -> CACATGGGACC
TCACATGGGAC -> CACATGGGACC,CACATGGGACG
CAATTTGCCAA -> AATTTGCCAAG
TAGCTTATGGT -> AGCTTATGGTT
CAAGGTCCAAT -> AAGGTCCAATA
ATGCGGACCCA -> TGCGGACCCAT
AATCCCGAATC -> ATCCCGAATCG
GGCACCCAATT -> GCACCCAATTT
GTATACAGAAT -> TATACAGAATG
CTCCAGGCTAT -> TCCAGGCTATG
ACCAGAAGGCG -> CCAGAAGGCGC
TACGTGAACGA -> ACGTGAACGAC
AACACTTAGCT -> ACACTTAGCTT
ATATGACGGGG -> TATGACGGGGG
GTACAAACCAT -> TACAAACCATA
ACACAAGACCC -> CACAAGACCCA
CAAGGAATCAC -> AAGGAATCACA
ATAGCTAGTTT -> TAGCTAGTTTT
GTAGTTCTGAG -> TAGTTCTGAGG
GAGGGCTCAGA -> AGGGCTCAGAG
CATACCCGCGA -> ATACCCGCGAA
TACCTTAGGGC -> ACCTTAGGGCC
AGTACGCGGAC -> GTACGCGGACA
AGTAGTTCTGA -> GTAGTTCTGAG
GGCCCCGCATA -> GCCCCGCATAT
TAGCTAGTTTT -> AGCTAGTTTTT
TGATCGTTATC -> GATCGTTATCA
CAACGAGAGCA -> AACGAGAGCAA
CGTGAACGACA -> GTGAACGACAG
TCTGACTTCAA -> CTGACTTCAAG
TTAGGGACGAA -> TAGGGACGAAG
GTCAATAGCTA -> TCAATAGCTAC
ACATGGGACGG -> CATGGGACGGG
AGGCCGCATGC -> GGCCGCATGCC
GACGGTAGCAT -> ACGGTAGCATT
CGCGCATGCGG -> GCGCATGCGGT
TGGTTAGCCCA -> GGTTAGCCCAG
CTGTCGCTGGC -> TGTCGCTGGCA
GAAGCAGGATA -> AAGCAGGATAA
GCATGCCAAAC -> CATGCCAAACC
ATCCCGCATCT -> TCCCGCATCTC
GGGTTATTTTA -> GGTTATTTTAG
CTAGTTTTTGC -> TAGTTTTTGCA
AAGTTCGGGGT -> AGTTCGGGGTC
CGATAAACCTC -> GATAAACCTCC
GATAACGTCTC -> ATAACGTCTCG
TTATTTTAGTG -> TATTTTAGTGG
CGGGTTTGGGG -> GGGTTTGGGGT
GTGCATCACGA -> TGCATCACGAC
TACCCCGCGCT -> ACCCCGCGCTA
ATATATTTAGG -> TATATTTAGGA
GGGACGGGTGC -> GGACGGGTGCA
ATGAGTCACGA -> TGAGTCACGAT
GGATTCCCTGG -> GATTCCCTGGA
CTACGTGAACG -> TACGTGAACGA
CAGAGTGTATC -> AGAGTGTATCA
GAGGGAGCCTC -> AGGGAGCCTCA
CGTCAATAGCT -> GTCAATAGCTA
TCTAGGGTTGG -> CTAGGGTTGGA
AGCCTACCCAG -> GCCTACCCAGA
TATTTTAGTGG -> ATTTTAGTGGC
GAGCCTCAGGG -> AGCCTCAGGGC
TACACGTCCTA -> ACACGTCCTAG
GCGGCCAACCC -> CGGCCAACCCC
TCTAATATGTC -> CTAATATGTCT
TCACTTACCCA -> CACTTACCCAA
GAAAGATAAGC -> AAAGATAAGCT
CAAGCTATTAG -> AAGCTATTAGG
GGTCGAACCAC -> GTCGAACCACT
CTCTTTGCGTC -> TCTTTGCGTCA
ACGGTTGCGGT -> CGGTTGCGGTT
GCTAACGCACG -> CTAACGCACGA
GCGTCACGTCA -> CGTCACGTCAA
TGAGGTACAAA -> GAGGTACAAAC
GATAAACAAGT -> ATAAACAAGTT
CTAAGGTCGAA -> TAAGGTCGAAC
AGTTACCGTGA -> GTTACCGTGAC
GATTGGCAAGG -> ATTGGCAAGGA
ACGTTGAATAG -> CGTTGAATAGG
TGATCACCACT -> GATCACCACTG
GCATCCCGCAT -> CATCCCGCATC
CATGAGGGAGC -> ATGAGGGAGCC
GCTCGCAGTAG -> CTCGCAGTAGA
GAGTCACACGT -> AGTCACACGTC
GCGGCAAGAAT -> CGGCAAGAATA
AGGGCCATGTT -> GGGCCATGTTA
GAGCGGATAAC -> AGCGGATAACG
TGTAGCTTATG -> GTAGCTTATGG
TACGCCCGCAG -> ACGCCCGCAGC
CGCGACATGCA -> GCGACATGCAG
TTAATCCTGCC -> TAATCCTGCCC
ACCGATATTAC -> CCGATATTACT
TTGAATAGGGT -> TGAATAGGGTA
CCCGCGCTAGA -> CCGCGCTAGAT
ATATAAATACG -> TATAAATACGC
AATTGGGTGGT -> ATTGGGTGGTG
GTGATCGTTAT -> TGATCGTTATC
TAAGACCTTTG -> AAGACCTTTGG
TATCTGAAGTC -> ATCTGAAGTCC
GAAATCGTGGC -> AAATCGTGGCC
GAGTGGGATCT -> AGTGGGATCTA
CCATGAGGGAG -> CATGAGGGAGC
GCGTATGGGGC -> CGTATGGGGCC
TTTGTGTGAGT -> TTGTGTGAGTC
GAAATCCTCTG -> AAATCCTCTGC
TCACGATAGAG -> CACGATAGAGG
GTGATACATTA -> TGATACATTAC
